1,Alex Abrines\abrinal01,SG,25,OKC,6,0,119,10,31,.323,7,23,.304,3,8,.375,.435,2,3,.667,1,6,7,4,7,1,3,11,29
2,Jaylen Adams\adamsja01,PG,22,ATL,4,0,13,1,4,.250,1,4,.250,0,0,,.375,0,0,,0,2,2,1,0,1,0,0,3
3,Steven Adams\adamsst01,C,25,OKC,5,5,173,30,55,.545,0,0,,30,55,.545,.545,14,28,.500,25,34,59,8,8,5,7,12,74
4,Bam Adebayo\adebaba01,C,21,MIA,7,0,124,18,37,.486,0,2,.000,18,35,.514,.486,16,23,.696,15,32,47,7,3,2,10,16,52
5,DeVaughn Akoon-Purcell\akoonde01,SG,25,DEN,1,0,3,0,2,.000,0,1,.000,0,1,.000,.000,1,2,.500,0,0,0,0,0,0,0,0,1
6,LaMarcus Aldridge\aldrila01,C,33,SAS,7,7,247,54,122,.443,0,4,.000,54,118,.458,.443,36,48,.750,30,34,64,22,4,9,12,14,144
7,Grayson Allen\allengr01,SG,23,UTA,5,0,41,6,12,.500,2,5,.400,4,7,.571,.583,8,8,1.000,0,2,2,2,0,0,2,3,22
8,Jarrett Allen\allenja01,C,20,BRK,8,8,211,37,60,.617,2,6,.333,35,54,.648,.633,13,24,.542,17,42,59,15,4,16,13,15,89
9,Al-Farouq Aminu\aminual01,PF,28,POR,7,7,199,17,48,.354,6,24,.250,11,24,.458,.417,13,15,.867,9,51,60,3,6,1,6,14,53
10,Kyle Anderson\anderky01,SF,25,MEM,6,3,138,10,26,.385,0,2,.000,10,24,.417,.385,4,8,.500,7,28,35,12,9,2,9,11,24
11,Ryan Anderson\anderry01,PF,30,PHO,7,6,147,15,41,.366,5,22,.227,10,19,.526,.427,9,10,.900,10,12,22,12,2,0,6,8,44
12,Ike Anigbogu\anigbik01,C,20,IND,1,0,3,0,2,.000,0,0,,0,2,.000,.000,0,0,,0,1,1,0,0,1,1,0,0
13,Giannis Antetokounmpo\antetgi01,PF,24,MIL,6,6,184,60,118,.508,1,16,.063,59,102,.578,.513,29,40,.725,18,67,85,34,4,10,30,23,150
14,Carmelo Anthony\anthoca01,PF,34,HOU,6,2,187,28,75,.373,12,35,.343,16,40,.400,.453,11,15,.733,6,27,33,4,4,6,6,20,79
15,OG Anunoby\anunoog01,SF,21,TOR,5,1,121,15,33,.455,6,18,.333,9,15,.600,.545,0,0,,4,13,17,3,3,2,4,13,36
16,Ryan Arcidiacono\arcidry01,PG,24,CHI,7,0,178,16,32,.500,11,24,.458,5,8,.625,.672,5,5,1.000,1,11,12,38,6,1,6,17,48
17,Trevor Ariza\arizatr01,SF,33,PHO,7,7,228,22,65,.338,13,39,.333,9,26,.346,.438,14,15,.933,4,30,34,25,5,1,12,10,71
18,D.J. Augustin\augusdj01,PG,31,ORL,7,7,183,19,55,.345,11,29,.379,8,26,.308,.445,11,12,.917,4,10,14,33,3,0,8,9,60
19,Deandre Ayton\aytonde01,C,20,PHO,7,7,217,53,86,.616,0,0,,53,86,.616,.616,12,14,.857,15,55,70,23,4,4,10,22,118
20,Dwayne Bacon\bacondw01,SG,23,CHO,3,0,21,4,8,.500,2,4,.500,2,4,.500,.625,4,4,1.000,0,2,2,2,1,0,0,2,14
21,Marvin Bagley\baglema01,PF,19,SAC,8,0,186,39,73,.534,5,9,.556,34,64,.531,.568,16,29,.552,23,34,57,10,6,10,20,19,99
22,Ron Baker\bakerro01,SG,25,NYK,6,0,79,1,10,.100,0,7,.000,1,3,.333,.100,3,4,.750,0,4,4,7,3,0,2,13,5
23,Wade Baldwin\baldwwa01,PG,22,POR,1,0,3,0,2,.000,0,1,.000,0,1,.000,.000,0,0,,0,2,2,0,0,0,2,0,0
24,Lonzo Ball\balllo01,PG,21,LAL,8,6,224,30,65,.462,16,39,.410,14,26,.538,.585,5,9,.556,6,30,36,36,9,0,11,15,81
25,Mohamed Bamba\bambamo01,C,20,ORL,7,0,144,17,33,.515,5,13,.385,12,20,.600,.591,1,5,.200,8,30,38,8,2,14,5,9,40
26,J.J. Barea\bareajo01,PG,34,DAL,8,0,149,25,78,.321,6,25,.240,19,53,.358,.359,8,14,.571,5,13,18,51,6,0,10,14,64
27,Harrison Barnes\barneha02,PF,26,DAL,4,4,125,22,60,.367,7,20,.350,15,40,.375,.425,7,12,.583,2,17,19,5,4,2,5,8,58
28,Will Barton\bartowi01,SG,28,DEN,2,2,54,12,21,.571,5,9,.556,7,12,.583,.690,4,4,1.000,0,10,10,6,1,2,3,5,33
29,Keita Bates-Diop\bateske01,SF,23,MIN,1,0,6,0,1,.000,0,0,,0,1,.000,.000,0,0,,0,1,1,0,0,0,0,0,0
30,Nicolas Batum\batumni01,SG,30,CHO,8,8,271,32,71,.451,15,38,.395,17,33,.515,.556,7,9,.778,8,42,50,27,9,7,16,11,86
31,Aron Baynes\baynear01,C,32,BOS,4,1,58,11,25,.440,4,10,.400,7,15,.467,.520,6,7,.857,10,10,20,4,0,1,2,9,32
32,Kent Bazemore\bazemke01,SG,29,ATL,7,7,210,39,83,.470,12,38,.316,27,45,.600,.542,15,23,.652,6,28,34,16,11,7,17,24,105
33,Bradley Beal\bealbr01,SG,25,WAS,7,7,233,58,128,.453,22,60,.367,36,68,.529,.539,20,28,.714,2,28,30,26,7,6,14,24,158
34,Malik Beasley\beaslma01,SG,22,DEN,7,0,123,19,40,.475,4,16,.250,15,24,.625,.525,0,0,,2,17,19,3,3,1,5,8,42
35,Michael Beasley\beaslmi01,PF,30,LAL,3,0,10,1,3,.333,0,0,,1,3,.333,.333,1,2,.500,1,2,3,0,0,0,2,3,3
36,Marco Belinelli\belinma01,SG,32,SAS,7,0,151,26,68,.382,10,33,.303,16,35,.457,.456,16,18,.889,1,14,15,10,5,1,7,11,78
37,Jordan Bell\belljo01,C,24,GSW,8,0,89,6,11,.545,0,0,,6,11,.545,.545,5,7,.714,5,14,19,4,4,9,4,11,17
38,DeAndre' Bembry\bembrde01,SF,24,ATL,7,0,175,22,56,.393,8,17,.471,14,39,.359,.464,6,14,.429,4,34,38,19,11,4,15,15,58
39,Dragan Bender\bendedr01,PF,21,PHO,4,0,14,2,4,.500,0,1,.000,2,3,.667,.500,0,0,,2,3,5,0,0,0,2,1,4
40,Davis Bertans\bertada01,PF,26,SAS,7,1,110,12,24,.500,10,19,.526,2,5,.400,.708,4,4,1.000,4,11,15,9,2,2,3,6,38
41,Patrick Beverley\beverpa01,SG,30,LAC,7,7,163,14,45,.311,6,25,.240,8,20,.400,.378,7,9,.778,4,31,35,33,4,2,10,25,41
42,Khem Birch\birchkh01,C,26,ORL,2,0,17,2,4,.500,0,0,,2,4,.500,.500,0,0,,0,2,2,0,2,0,0,0,4
43,Bismack Biyombo\biyombi01,C,26,CHO,4,0,45,4,8,.500,0,0,,4,8,.500,.500,2,5,.400,4,9,13,1,0,7,2,8,10
44,Nemanja Bjelica\bjeline01,PF,30,SAC,8,8,220,46,79,.582,18,33,.545,28,46,.609,.696,11,17,.647,10,42,52,24,10,8,9,22,121
45,Antonio Blakeney\blakean01,SG,22,CHI,8,0,138,34,65,.523,13,22,.591,21,43,.488,.623,9,17,.529,1,17,18,4,1,2,3,8,90
46,Eric Bledsoe\bledser01,PG,29,MIL,7,7,194,36,76,.474,11,32,.344,25,44,.568,.546,9,10,.900,10,23,33,48,6,7,14,18,92
47,Bojan Bogdanovic\bogdabo02,SF,29,IND,8,8,242,41,78,.526,16,31,.516,25,47,.532,.628,15,18,.833,2,28,30,6,2,0,15,11,113
48,Jonah Bolden\boldejo01,PF,23,PHI,4,0,15,2,6,.333,0,4,.000,2,2,1.000,.333,1,2,.500,0,2,2,1,0,1,1,2,5
49,Devin Booker\bookede01,SG,22,PHO,4,4,137,36,71,.507,12,31,.387,24,40,.600,.592,27,33,.818,1,17,18,27,3,0,22,15,111
50,Chris Boucher\bouchch01,PF,26,TOR,1,0,2,1,2,.500,0,1,.000,1,1,1.000,.500,4,6,.667,2,0,2,0,0,1,0,0,6
51,Avery Bradley\bradlav01,SG,28,LAC,7,7,188,24,63,.381,6,23,.261,18,40,.450,.429,1,1,1.000,5,9,14,12,5,3,10,23,55
52,Mikal Bridges\bridgmi01,SF,22,PHO,7,0,118,17,37,.459,6,18,.333,11,19,.579,.541,9,11,.818,2,11,13,8,8,0,6,12,49
53,Miles Bridges\bridgmi02,SF,20,CHO,7,0,133,23,38,.605,7,16,.438,16,22,.727,.697,3,7,.429,4,19,23,8,5,2,5,9,56
54,Isaiah Briscoe\briscis01,PG,22,ORL,3,0,23,4,8,.500,1,1,1.000,3,7,.429,.563,1,3,.333,0,2,2,5,0,0,1,2,10
55,Ryan Broekhoff\broekry01,SG,28,DAL,5,0,15,2,8,.250,2,8,.250,0,0,,.375,0,0,,0,2,2,0,0,0,0,1,6
56,Malcolm Brogdon\brogdma01,PG,26,MIL,7,7,215,34,68,.500,10,24,.417,24,44,.545,.574,13,13,1.000,3,22,25,27,4,1,14,16,91
57,Dillon Brooks\brookdi01,SF,23,MEM,6,0,110,9,28,.321,3,9,.333,6,19,.316,.375,7,10,.700,3,10,13,7,5,2,5,16,28
58,MarShon Brooks\brookma01,SG,30,MEM,5,0,64,12,26,.462,2,10,.200,10,16,.625,.500,7,9,.778,1,7,8,3,1,0,3,6,33
59,Bruce Brown\brownbr01,SG,22,DET,5,1,74,9,24,.375,1,10,.100,8,14,.571,.396,6,9,.667,2,5,7,2,3,2,3,15,25
60,Jaylen Brown\brownja02,SG,22,BOS,7,7,204,27,75,.360,9,28,.321,18,47,.383,.420,13,21,.619,10,19,29,13,4,3,9,22,76
61,Lorenzo Brown\brownlo01,PG,28,TOR,7,0,64,8,23,.348,2,10,.200,6,13,.462,.391,0,0,,1,7,8,8,3,2,5,6,18
62,Sterling Brown\brownst02,SG,23,MIL,5,0,26,2,8,.250,0,3,.000,2,5,.400,.250,0,0,,2,7,9,1,0,0,3,2,4
63,Troy Brown\browntr01,SF,19,WAS,2,0,14,2,6,.333,1,1,1.000,1,5,.200,.417,2,2,1.000,1,4,5,0,1,0,1,1,7
64,Jalen Brunson\brunsja01,PG,22,DAL,8,1,139,16,48,.333,6,22,.273,10,26,.385,.396,4,4,1.000,0,11,11,12,3,0,5,9,42
65,Thomas Bryant\bryanth01,C,21,WAS,2,0,20,4,12,.333,0,4,.000,4,8,.500,.333,5,5,1.000,4,3,7,1,0,0,1,1,13
66,Reggie Bullock\bullore01,SF,27,DET,6,6,171,20,61,.328,7,28,.250,13,33,.394,.385,13,15,.867,2,12,14,12,1,2,6,10,60
67,Trey Burke\burketr01,PG,26,NYK,8,5,170,33,83,.398,9,24,.375,24,59,.407,.452,7,11,.636,7,11,18,29,4,0,9,9,82
68,Alec Burks\burksal01,SG,27,UTA,5,0,55,8,21,.381,4,8,.500,4,13,.308,.476,10,11,.909,0,7,7,5,2,1,2,3,30
69,Deonte Burton\burtode02,SG,25,OKC,3,0,13,2,6,.333,1,2,.500,1,4,.250,.417,0,0,,0,1,1,0,0,1,0,1,5
70,Jimmy Butler\butleji01,SG,29,MIN,6,6,202,46,91,.505,12,25,.480,34,66,.515,.571,31,37,.838,10,22,32,20,18,8,9,8,135
71,Jose Calderon\caldejo01,PG,37,DET,4,0,42,4,10,.400,3,7,.429,1,3,.333,.550,2,2,1.000,1,3,4,2,2,1,1,6,13
72,Kentavious Caldwell-Pope\caldwke01,SG,25,LAL,8,3,163,15,42,.357,4,18,.222,11,24,.458,.405,13,14,.929,1,14,15,3,3,1,5,6,47
73,Isaiah Canaan\canaais01,PG,27,PHO,6,6,153,17,42,.405,6,22,.273,11,20,.550,.476,5,6,.833,3,18,21,19,4,0,12,14,45
74,Clint Capela\capelca01,C,24,HOU,6,6,196,41,69,.594,0,0,,41,69,.594,.594,6,16,.375,26,41,67,10,3,11,14,15,88
75,Vince Carter\cartevi01,SF,42,ATL,7,7,149,19,48,.396,13,32,.406,6,16,.375,.531,6,7,.857,2,16,18,8,5,2,6,14,57
76,Wendell Carter\cartewe01,PF,19,CHI,8,8,204,34,78,.436,3,9,.333,31,69,.449,.455,15,21,.714,15,35,50,21,5,14,11,22,86
77,Michael Carter-Williams\cartemi01,PG,27,HOU,6,1,91,13,35,.371,2,10,.200,11,25,.440,.400,7,14,.500,2,8,10,13,6,4,8,15,35
78,Omri Casspi\casspom01,SF,30,MEM,5,0,73,12,22,.545,3,7,.429,9,15,.600,.614,6,11,.545,2,12,14,7,3,0,2,4,33
79,Willie Cauley-Stein\caulewi01,C,25,SAC,8,8,242,60,108,.556,0,0,,60,108,.556,.556,19,35,.543,23,49,72,21,8,3,8,21,139
80,Tyson Chandler\chandty01,C,36,PHO,7,0,89,8,12,.667,0,0,,8,12,.667,.667,10,18,.556,7,32,39,6,2,1,7,21,26
81,Marquese Chriss\chrisma01,F,21,HOU,1,0,8,2,5,.400,0,2,.000,2,3,.667,.400,0,0,,0,2,2,0,0,1,1,1,4
82,Gary Clark\clarkga01,PF,24,HOU,5,0,38,6,15,.400,5,13,.385,1,2,.500,.567,0,0,,2,6,8,1,0,1,0,7,17
83,Ian Clark\clarkia01,SG,27,NOP,6,0,71,11,18,.611,5,8,.625,6,10,.600,.750,2,2,1.000,0,4,4,4,0,0,3,12,29
84,Jordan Clarkson\clarkjo01,SG,26,CLE,7,0,160,46,92,.500,9,28,.321,37,64,.578,.549,11,12,.917,4,15,19,8,4,1,10,10,112
85,Zach Collins\colliza01,C,21,POR,7,0,153,28,43,.651,6,12,.500,22,31,.710,.721,16,18,.889,8,25,33,10,4,14,10,26,78
86,Darren Collison\collida01,PG,31,IND,8,8,207,29,61,.475,4,12,.333,25,49,.510,.508,11,14,.786,2,14,16,38,12,0,12,14,73
87,Mike Conley\conlemi01,PG,31,MEM,6,6,188,37,97,.381,11,39,.282,26,58,.448,.438,29,34,.853,5,17,22,37,8,1,10,13,114
88,Pat Connaughton\connapa01,SG,26,MIL,4,0,57,9,25,.360,5,14,.357,4,11,.364,.460,2,4,.500,2,19,21,2,1,1,3,5,25
89,Quinn Cook\cookqu01,PG,25,GSW,7,0,72,12,28,.429,4,12,.333,8,16,.500,.500,6,7,.857,1,5,6,5,2,0,5,7,34
90,Robert Covington\covinro01,SF,28,PHI,8,8,280,36,85,.424,24,56,.429,12,29,.414,.565,12,17,.706,6,39,45,8,16,14,14,25,108
91,Allen Crabbe\crabbal01,SG,26,BRK,7,0,157,14,54,.259,11,36,.306,3,18,.167,.361,12,16,.750,2,24,26,9,1,3,10,19,51
92,Torrey Craig\craigto01,SF,28,DEN,6,5,123,10,26,.385,2,15,.133,8,11,.727,.423,3,4,.750,8,11,19,4,4,3,5,16,25
93,Jamal Crawford\crawfja01,SG,38,PHO,6,0,67,7,20,.350,4,12,.333,3,8,.375,.450,8,8,1.000,0,4,4,9,2,0,4,5,26
94,Jae Crowder\crowdja01,SF,28,UTA,7,1,215,28,66,.424,14,40,.350,14,26,.538,.530,21,27,.778,8,33,41,13,5,0,1,21,91
95,Dante Cunningham\cunnida01,SF,31,SAS,7,4,142,7,22,.318,2,8,.250,5,14,.357,.364,4,4,1.000,6,22,28,7,4,1,2,11,20
96,Seth Curry\curryse01,SG,28,POR,7,0,130,15,36,.417,8,16,.500,7,20,.350,.528,1,1,1.000,2,8,10,7,0,1,6,11,39
97,Stephen Curry\curryst01,PG,30,GSW,9,9,306,100,182,.549,55,104,.529,45,78,.577,.701,42,46,.913,3,42,45,53,12,2,25,20,297
98,Troy Daniels\danietr01,SG,27,PHO,4,0,37,5,15,.333,3,11,.273,2,4,.500,.433,1,1,1.000,1,3,4,4,4,0,3,6,14
99,Anthony Davis\davisan02,PF,25,NOP,5,5,185,44,89,.494,5,11,.455,39,78,.500,.522,33,46,.717,18,47,65,26,10,16,8,16,126
100,Ed Davis\davised01,C,29,BRK,8,0,136,21,35,.600,0,0,,21,35,.600,.600,10,16,.625,26,43,69,7,2,3,8,20,52
101,Dewayne Dedmon\dedmode01,C,29,ATL,4,0,80,12,26,.462,3,7,.429,9,19,.474,.519,4,4,1.000,6,21,27,3,1,8,1,9,31
102,Sam Dekker\dekkesa01,PF,24,CLE,6,2,96,14,25,.560,4,7,.571,10,18,.556,.640,6,8,.750,6,21,27,7,8,0,3,8,38
103,Matthew Dellavedova\dellama01,PG,28,MIL,4,0,25,3,9,.333,3,6,.500,0,3,.000,.500,0,0,,0,2,2,4,0,0,3,2,9
104,Luol Deng\denglu01,SF,33,MIN,1,0,12,2,7,.286,0,3,.000,2,4,.500,.286,0,0,,3,2,5,0,0,1,0,0,4
105,DeMar DeRozan\derozde01,SG,29,SAS,7,7,261,76,146,.521,3,11,.273,73,135,.541,.531,40,46,.870,4,36,40,51,9,2,15,21,195
106,Cheick Diallo\diallch01,PF,22,NOP,4,0,30,9,14,.643,0,0,,9,14,.643,.643,4,6,.667,3,10,13,3,1,1,4,4,22
107,Hamidou Diallo\diallha01,SG,20,OKC,5,0,69,11,24,.458,1,3,.333,10,21,.476,.479,5,7,.714,6,7,13,3,5,3,3,12,28
108,Gorgui Dieng\dienggo01,C,29,MIN,8,0,119,23,43,.535,2,8,.250,21,35,.600,.558,17,20,.850,10,30,40,7,5,3,9,18,65
109,Spencer Dinwiddie\dinwisp01,PG,25,BRK,8,0,220,43,88,.489,20,46,.435,23,42,.548,.602,13,16,.813,4,16,20,29,3,4,18,22,119
110,Donte DiVincenzo\divindo01,SG,22,MIL,7,0,141,21,45,.467,8,27,.296,13,18,.722,.556,8,10,.800,4,24,28,11,2,2,9,10,58
111,Luka Doncic\doncilu01,SF,19,DAL,8,8,278,55,120,.458,22,55,.400,33,65,.508,.550,25,35,.714,8,42,50,35,7,3,32,15,157
112,Tyler Dorsey\dorsety01,SG,22,ATL,4,0,35,6,15,.400,2,5,.400,4,10,.400,.467,0,0,,0,3,3,3,0,0,0,3,14
113,Damyean Dotson\dotsoda01,SG,24,NYK,6,3,178,31,68,.456,14,37,.378,17,31,.548,.559,3,4,.750,6,29,35,5,7,1,4,10,79
114,Goran Dragic\dragigo01,PG,32,MIA,7,7,222,43,103,.417,17,45,.378,26,58,.448,.500,21,26,.808,5,19,24,35,3,2,16,18,124
115,Andre Drummond\drumman01,C,25,DET,7,7,226,56,114,.491,1,8,.125,55,106,.519,.496,20,32,.625,40,74,114,8,6,10,22,29,133
116,Jared Dudley\dudleja01,PF,33,BRK,8,8,210,16,43,.372,10,32,.313,6,11,.545,.488,7,8,.875,7,19,26,20,8,2,4,23,49
117,Kris Dunn\dunnkr01,PG,24,CHI,1,1,30,4,13,.308,1,4,.250,3,9,.333,.346,0,0,,0,4,4,7,0,0,4,6,9
118,Kevin Durant\duranke01,PF,30,GSW,9,9,318,95,170,.559,14,38,.368,81,132,.614,.600,46,50,.920,2,63,65,57,9,6,23,14,250
119,Henry Ellenson\ellenhe01,PF,22,DET,1,0,8,2,5,.400,1,2,.500,1,3,.333,.500,2,2,1.000,0,3,3,0,0,0,0,1,7
120,Joel Embiid\embiijo01,C,24,PHI,8,8,277,75,157,.478,10,34,.294,65,123,.528,.510,56,67,.836,20,74,94,33,2,17,19,26,216
121,James Ennis\ennisja01,SF,28,HOU,3,3,70,7,19,.368,6,14,.429,1,5,.200,.526,0,0,,6,3,9,3,3,0,2,12,20
122,Drew Eubanks\eubandr01,PF,21,SAS,2,0,6,1,2,.500,0,0,,1,2,.500,.500,2,2,1.000,0,0,0,0,0,0,0,0,4
123,Jacob Evans\evansja02,SG,21,GSW,6,0,38,2,7,.286,0,0,,2,7,.286,.286,0,0,,1,2,3,7,1,0,1,4,4
124,Tyreke Evans\evansty01,PG,29,IND,7,0,141,28,66,.424,9,21,.429,19,45,.422,.492,7,12,.583,3,17,20,21,8,5,10,15,72
125,Dante Exum\exumda01,PG,23,UTA,7,0,132,23,55,.418,5,16,.313,18,39,.462,.464,19,26,.731,4,13,17,14,2,2,7,10,70
126,Kenneth Faried\farieke01,PF,29,BRK,3,0,15,4,5,.800,0,0,,4,5,.800,.800,0,0,,1,3,4,0,1,0,2,0,8
127,Derrick Favors\favorde01,C,27,UTA,6,6,134,24,49,.490,1,9,.111,23,40,.575,.500,14,20,.700,18,26,44,2,3,7,11,20,63
128,Cristiano Felicio\feliccr01,C,26,CHI,5,0,108,10,19,.526,0,0,,10,19,.526,.526,8,10,.800,9,21,30,3,3,1,5,8,28
129,Raymond Felton\feltora01,PG,34,OKC,2,0,32,6,17,.353,0,6,.000,6,11,.545,.353,6,7,.857,1,6,7,4,0,1,3,2,18
130,Terrance Ferguson\fergute01,SG,20,OKC,6,6,130,7,23,.304,1,13,.077,6,10,.600,.326,1,2,.500,5,5,10,2,4,1,6,14,16
131,Yogi Ferrell\ferreyo01,SG,25,SAC,7,2,123,17,38,.447,5,14,.357,12,24,.500,.513,10,10,1.000,2,9,11,5,4,1,4,5,49
132,Dorian Finney-Smith\finnedo01,PF,25,DAL,8,4,201,23,49,.469,11,29,.379,12,20,.600,.582,5,6,.833,12,14,26,6,7,4,8,25,62
133,Bryn Forbes\forbebr01,SG,25,SAS,7,7,208,35,75,.467,15,36,.417,20,39,.513,.567,9,11,.818,2,10,12,19,7,0,9,19,94
134,Evan Fournier\fournev01,SF,26,ORL,7,7,201,40,107,.374,13,47,.277,27,60,.450,.435,13,16,.813,1,18,19,28,3,0,7,16,106
135,De'Aaron Fox\foxde01,PG,21,SAC,8,8,259,51,106,.481,4,19,.211,47,87,.540,.500,34,54,.630,5,26,31,55,12,4,27,23,140
136,Tim Frazier\fraziti01,PG,28,NOP,4,1,58,6,11,.545,3,7,.429,3,4,.750,.682,0,1,.000,2,6,8,9,2,1,4,9,15
137,Channing Frye\fryech01,C,35,CLE,1,1,21,2,4,.500,1,2,.500,1,2,.500,.625,0,0,,0,4,4,1,0,0,0,4,5
138,Markelle Fultz\fultzma01,SG,20,PHI,8,8,197,33,83,.398,4,13,.308,29,70,.414,.422,7,11,.636,10,19,29,31,8,1,12,23,77
139,Danilo Gallinari\gallida01,SF,30,LAC,7,7,202,45,98,.459,15,32,.469,30,66,.455,.536,35,36,.972,10,33,43,10,5,4,7,16,140
140,Langston Galloway\gallola01,SG,27,DET,6,0,134,11,31,.355,3,21,.143,8,10,.800,.403,5,6,.833,1,11,12,4,2,1,1,9,30
141,Marc Gasol\gasolma01,C,34,MEM,6,6,190,31,72,.431,12,24,.500,19,48,.396,.514,18,24,.750,4,45,49,21,12,3,7,11,92
142,Pau Gasol\gasolpa01,C,38,SAS,7,0,121,17,33,.515,3,5,.600,14,28,.500,.561,10,12,.833,10,33,43,22,1,6,6,10,47
143,Rudy Gay\gayru01,PF,32,SAS,7,6,205,42,80,.525,9,14,.643,33,66,.500,.581,7,11,.636,10,49,59,14,9,4,17,18,100
144,Paul George\georgpa01,SF,28,OKC,6,6,209,51,123,.415,19,55,.345,32,68,.471,.492,32,41,.780,4,36,40,21,13,4,21,25,153
145,Taj Gibson\gibsota01,PF,33,MIN,8,8,211,36,60,.600,2,6,.333,34,54,.630,.617,9,14,.643,22,31,53,8,7,9,10,21,83
146,Harry Giles\gilesha01,PF,20,SAC,6,0,70,10,31,.323,0,1,.000,10,30,.333,.323,2,7,.286,4,13,17,5,2,2,10,20,22
147,Shai Gilgeous-Alexander\gilgesh01,PG,20,LAC,7,0,181,21,43,.488,3,6,.500,18,37,.486,.523,14,16,.875,5,18,23,25,7,3,13,12,59
148,Rudy Gobert\goberru01,C,26,UTA,7,7,238,48,64,.750,0,0,,48,64,.750,.750,32,47,.681,26,68,94,8,10,19,15,21,128
149,Aaron Gordon\gordoaa01,PF,23,ORL,7,7,227,39,91,.429,10,33,.303,29,58,.500,.484,20,32,.625,16,44,60,17,6,8,18,21,108
150,Eric Gordon\gordoer01,SG,30,HOU,6,4,198,30,98,.306,11,47,.234,19,51,.373,.362,13,15,.867,5,18,23,9,2,5,5,12,84
151,Marcin Gortat\gortama01,C,34,LAC,7,7,124,10,24,.417,0,0,,10,24,.417,.417,9,11,.818,12,30,42,11,0,5,7,15,29
152,Devonte' Graham\grahade01,PG,23,CHO,2,0,19,3,6,.500,1,3,.333,2,3,.667,.583,0,0,,0,2,2,3,0,0,1,2,7
153,Treveon Graham\grahatr01,SG,25,BRK,2,0,27,0,3,.000,0,2,.000,0,1,.000,.000,0,0,,1,3,4,1,1,0,2,5,0
154,Jerami Grant\grantje01,PF,24,OKC,6,3,178,19,49,.388,4,19,.211,15,30,.500,.429,12,22,.545,8,20,28,8,5,8,8,18,54
155,Jerian Grant\grantje02,PG,26,ORL,7,0,145,12,36,.333,3,13,.231,9,23,.391,.375,2,4,.500,5,13,18,18,8,1,11,11,29
156,Danny Green\greenda02,SG,31,TOR,8,8,249,29,65,.446,22,47,.468,7,18,.389,.615,5,5,1.000,6,32,38,13,9,8,6,18,85
157,Draymond Green\greendr01,PF,28,GSW,9,9,283,29,61,.475,6,21,.286,23,40,.575,.525,11,16,.688,8,57,65,73,18,7,28,30,75
158,Gerald Green\greenge01,SG,33,HOU,6,0,126,18,47,.383,11,37,.297,7,10,.700,.500,3,3,1.000,5,13,18,4,3,1,4,10,50
159,JaMychal Green\greenja01,PF,28,MEM,2,2,39,6,15,.400,1,2,.500,5,13,.385,.433,2,2,1.000,4,8,12,4,4,0,4,4,15
160,Jeff Green\greenje02,PF,32,WAS,7,1,183,25,56,.446,3,20,.150,22,36,.611,.473,17,17,1.000,8,29,37,10,4,5,12,16,70
161,Blake Griffin\griffbl01,PF,29,DET,7,7,255,67,136,.493,19,39,.487,48,97,.495,.563,38,52,.731,14,60,74,30,3,5,22,19,191
162,Tim Hardaway\hardati02,SG,26,NYK,8,8,267,69,160,.431,30,73,.411,39,87,.448,.525,40,44,.909,3,21,24,26,7,0,17,24,208
163,James Harden\hardeja01,SG,29,HOU,4,4,144,37,79,.468,15,34,.441,22,45,.489,.563,25,34,.735,4,21,25,36,8,2,20,9,114
164,Maurice Harkless\harklma01,SF,25,POR,5,0,88,7,18,.389,3,8,.375,4,10,.400,.472,2,2,1.000,3,21,24,5,2,6,2,10,19
165,Montrezl Harrell\harremo01,C,25,LAC,7,0,143,32,50,.640,0,0,,32,50,.640,.640,27,37,.730,5,36,41,8,6,13,12,20,91
166,Devin Harris\harride01,PG,35,DAL,1,0,6,0,2,.000,0,1,.000,0,1,.000,.000,0,0,,0,0,0,1,0,0,0,0,0
167,Gary Harris\harriga01,SG,24,DEN,7,7,238,53,110,.482,9,32,.281,44,78,.564,.523,21,27,.778,7,21,28,25,8,3,6,15,136
168,Joe Harris\harrijo01,SG,27,BRK,8,8,243,39,75,.520,23,42,.548,16,33,.485,.673,6,8,.750,7,26,33,19,4,1,16,23,107
169,Tobias Harris\harrito02,PF,26,LAC,7,7,239,54,109,.495,12,33,.364,42,76,.553,.550,26,33,.788,11,49,60,12,2,5,14,11,146
170,Andrew Harrison\harrian01,PG,24,MEM,1,0,5,1,2,.500,0,1,.000,1,1,1.000,.500,0,0,,0,0,0,0,0,0,0,1,2
171,Shaquille Harrison\harrish01,PG,25,CHI,3,0,36,8,16,.500,2,5,.400,6,11,.545,.563,5,10,.500,3,5,8,7,2,0,3,7,23
172,Josh Hart\hartjo01,SG,23,LAL,8,3,232,35,78,.449,17,42,.405,18,36,.500,.558,8,15,.533,3,31,34,11,14,3,11,24,95
173,Isaiah Hartenstein\harteis01,PF,20,HOU,5,0,34,4,8,.500,0,2,.000,4,6,.667,.500,4,4,1.000,2,1,3,4,1,2,2,11,12
174,Udonis Haslem\hasleud01,C,38,MIA,1,0,4,0,2,.000,0,2,.000,0,0,,.000,0,0,,0,1,1,0,0,0,2,1,0
175,Gordon Hayward\haywago01,SF,28,BOS,6,6,147,24,59,.407,8,22,.364,16,37,.432,.475,5,10,.500,5,27,32,10,7,0,9,10,61
176,John Henson\hensojo01,C,28,MIL,7,0,111,16,38,.421,5,13,.385,11,25,.440,.487,5,8,.625,13,39,52,6,6,9,8,10,42
177,Juan Hernangomez\hernaju01,PF,23,DEN,6,0,94,9,22,.409,4,12,.333,5,10,.500,.500,0,0,,6,17,23,3,3,2,2,8,22
178,Willy Hernangomez\hernawi01,C,24,CHO,7,0,97,16,30,.533,2,5,.400,14,25,.560,.567,15,19,.789,14,23,37,5,4,1,8,14,49
179,Mario Hezonja\hezonma01,SF,23,NYK,8,0,145,29,79,.367,8,32,.250,21,47,.447,.418,4,9,.444,1,24,25,9,5,0,11,13,70
180,Buddy Hield\hieldbu01,SG,25,SAC,8,8,257,59,113,.522,17,38,.447,42,75,.560,.597,16,19,.842,7,42,49,19,3,5,21,19,151
181,George Hill\hillge01,PG,32,CLE,7,7,180,35,65,.538,8,17,.471,27,48,.563,.600,13,15,.867,7,6,13,17,5,1,9,18,91
182,Solomon Hill\hillso01,SF,27,NOP,7,1,132,8,28,.286,3,13,.231,5,15,.333,.339,3,4,.750,2,13,15,14,6,3,4,11,22
183,Aaron Holiday\holidaa01,PG,22,IND,5,0,16,2,6,.333,1,4,.250,1,2,.500,.417,0,0,,0,1,1,2,0,0,3,2,5
184,Jrue Holiday\holidjr01,SG,28,NOP,7,7,246,44,102,.431,7,33,.212,37,69,.536,.466,26,32,.813,6,24,30,56,12,4,22,16,121
185,Justin Holiday\holidju01,SG,29,CHI,8,8,274,32,76,.421,22,55,.400,10,21,.476,.566,7,8,.875,3,28,31,20,11,3,4,17,93
186,John Holland\hollajo02,SF,30,CLE,1,0,1,0,0,,0,0,,0,0,,,0,0,,0,0,0,0,0,0,0,0,0
187,Rondae Hollis-Jefferson\holliro01,SF,24,BRK,5,0,107,20,50,.400,0,4,.000,20,46,.435,.400,3,6,.500,4,26,30,5,3,4,3,7,43
188,Richaun Holmes\holmeri01,C,25,PHO,6,0,26,1,2,.500,0,0,,1,2,.500,.500,2,4,.500,4,5,9,2,1,1,1,4,4
189,Rodney Hood\hoodro01,SG,26,CLE,7,7,194,39,85,.459,6,19,.316,33,66,.500,.494,14,16,.875,4,14,18,13,8,0,4,18,98
190,Al Horford\horfoal01,C,32,BOS,7,7,205,31,72,.431,9,31,.290,22,41,.537,.493,9,12,.750,14,34,48,25,5,10,13,19,80
191,Kevin Huerter\huertke01,SG,20,ATL,7,0,110,12,29,.414,8,18,.444,4,11,.364,.552,4,5,.800,6,23,29,10,3,2,5,5,36
192,Chandler Hutchison\hutchch01,SF,22,CHI,7,3,132,10,25,.400,1,7,.143,9,18,.500,.420,5,10,.500,5,21,26,3,3,2,4,10,26
193,Serge Ibaka\ibakase01,PF,29,TOR,8,5,225,54,103,.524,4,19,.211,50,84,.595,.544,21,28,.750,22,40,62,8,5,12,18,24,133
194,Andre Iguodala\iguodan01,SF,35,GSW,8,0,151,9,22,.409,2,9,.222,7,13,.538,.455,3,4,.750,3,16,19,19,6,6,7,12,23
195,Ersan Ilyasova\ilyaser01,PF,31,MIL,7,1,160,25,48,.521,8,22,.364,17,26,.654,.604,8,11,.727,11,37,48,11,5,3,6,21,66
196,Joe Ingles\inglejo01,SF,31,UTA,7,7,234,38,81,.469,19,47,.404,19,34,.559,.586,6,9,.667,2,34,36,30,12,1,20,18,101
197,Brandon Ingram\ingrabr01,SF,21,LAL,4,4,113,27,57,.474,4,11,.364,23,46,.500,.509,11,16,.688,6,10,16,4,4,5,11,14,69
198,Kyrie Irving\irvinky01,PG,26,BOS,7,7,221,44,103,.427,11,36,.306,33,67,.493,.481,16,21,.762,5,29,34,38,6,3,17,12,115
199,Jonathan Isaac\isaacjo01,PF,21,ORL,7,7,164,21,49,.429,5,18,.278,16,31,.516,.480,8,11,.727,10,32,42,4,6,8,6,16,55
200,Wesley Iwundu\iwundwe01,SF,24,ORL,3,0,45,6,20,.300,0,4,.000,6,16,.375,.300,7,9,.778,5,6,11,0,1,0,1,4,19
201,Frank Jackson\jacksfr01,PG,20,NOP,5,0,75,10,27,.370,5,11,.455,5,16,.313,.463,7,9,.778,0,2,2,5,2,0,1,8,32
202,Jaren Jackson\jacksja02,PF,19,MEM,6,4,136,25,54,.463,2,13,.154,23,41,.561,.481,17,21,.810,8,23,31,8,7,6,7,26,69
203,Josh Jackson\jacksjo02,SF,21,PHO,7,3,161,22,60,.367,5,21,.238,17,39,.436,.408,4,11,.364,0,12,12,15,5,5,24,24,53
204,Justin Jackson\jacksju01,SF,23,SAC,8,2,215,22,59,.373,6,29,.207,16,30,.533,.424,6,8,.750,4,28,32,15,6,2,3,11,56
205,Reggie Jackson\jacksre01,PG,28,DET,7,7,213,35,98,.357,16,48,.333,19,50,.380,.439,27,32,.844,5,14,19,25,2,1,10,21,113
206,LeBron James\jamesle01,PF,34,LAL,8,8,291,81,159,.509,12,44,.273,69,115,.600,.547,48,61,.787,8,61,69,64,17,4,26,17,222
207,Jonas Jerebko\jerebjo01,PF,31,GSW,9,0,148,21,41,.512,11,23,.478,10,18,.556,.646,12,15,.800,7,32,39,14,6,1,6,25,65
208,Alize Johnson\johnsal02,PF,22,IND,3,0,9,1,2,.500,0,0,,1,2,.500,.500,0,2,.000,0,4,4,0,0,0,0,3,2
209,Amir Johnson\johnsam01,C,31,PHI,8,0,93,17,25,.680,0,2,.000,17,23,.739,.680,9,13,.692,8,24,32,11,2,3,9,15,43
210,Stanley Johnson\johnsst04,SF,22,DET,6,6,169,18,47,.383,8,28,.286,10,19,.526,.468,4,5,.800,6,24,30,11,4,1,13,15,48
211,Tyler Johnson\johnsty01,PG,26,MIA,7,0,168,22,54,.407,5,25,.200,17,29,.586,.454,9,14,.643,3,12,15,15,9,3,6,12,58
212,Wesley Johnson\johnswe01,SF,31,NOP,2,0,25,3,6,.500,2,4,.500,1,2,.500,.667,1,2,.500,0,2,2,0,2,1,2,5,9
213,Nikola Jokic\jokicni01,C,23,DEN,7,7,214,51,94,.543,11,25,.440,40,69,.580,.601,38,44,.864,16,58,74,50,9,9,19,24,151
214,Damian Jones\jonesda03,C,23,GSW,9,9,146,24,31,.774,0,0,,24,31,.774,.774,6,13,.462,12,10,22,11,6,11,5,27,54
215,Derrick Jones\jonesde02,SF,21,MIA,4,3,76,13,32,.406,3,9,.333,10,23,.435,.453,7,11,.636,6,5,11,4,2,2,4,13,36
216,Tyus Jones\jonesty01,PG,22,MIN,7,0,126,16,47,.340,8,19,.421,8,28,.286,.426,2,2,1.000,1,7,8,17,8,1,3,6,42
217,DeAndre Jordan\jordade01,C,30,DAL,8,8,271,41,61,.672,0,0,,41,61,.672,.672,28,34,.824,29,90,119,21,5,13,21,24,110
218,Cory Joseph\josepco01,PG,27,IND,8,0,197,25,48,.521,8,15,.533,17,33,.515,.604,2,4,.500,1,25,26,29,8,3,9,13,60
219,Frank Kaminsky\kaminfr01,PF,25,CHO,3,0,17,2,7,.286,0,3,.000,2,4,.500,.286,0,0,,0,3,3,2,0,0,2,1,4
220,Enes Kanter\kanteen01,C,26,NYK,8,5,212,49,94,.521,1,3,.333,48,91,.527,.527,15,17,.882,29,59,88,18,5,2,19,25,114
221,Luke Kennard\kennalu01,SG,22,DET,3,1,43,8,12,.667,1,2,.500,7,10,.700,.708,0,0,,0,5,5,3,1,1,1,2,17
222,Michael Kidd-Gilchrist\kiddgmi01,SF,25,CHO,8,0,173,30,56,.536,2,4,.500,28,52,.538,.554,14,21,.667,17,29,46,14,2,12,7,29,76
223,Maxi Kleber\klebima01,PF,27,DAL,8,0,156,21,42,.500,10,26,.385,11,16,.688,.619,7,11,.636,10,25,35,3,3,13,6,9,59
224,Kevin Knox\knoxke01,SF,19,NYK,3,0,56,11,31,.355,4,9,.444,7,22,.318,.419,2,5,.400,3,3,6,0,2,1,2,5,28
225,Furkan Korkmaz\korkmfu01,SG,21,PHI,5,0,26,2,5,.400,0,3,.000,2,2,1.000,.400,0,0,,0,5,5,0,1,0,0,3,4
226,Luke Kornet\kornelu01,PF,23,NYK,3,0,11,0,1,.000,0,1,.000,0,0,,.000,0,0,,0,0,0,2,0,0,1,0,0
227,Kyle Korver\korveky01,SG,37,CLE,6,0,91,12,24,.500,5,15,.333,7,9,.778,.604,4,5,.800,0,7,7,7,1,0,5,12,33
228,Kosta Koufos\koufoko01,C,29,SAC,2,0,25,5,7,.714,0,0,,5,7,.714,.714,0,0,,1,8,9,1,1,1,0,3,10
229,Rodions Kurucs\kurucro01,SF,20,BRK,3,0,43,9,19,.474,4,10,.400,5,9,.556,.579,4,4,1.000,4,8,12,1,0,0,5,3,26
230,Kyle Kuzma\kuzmaky01,PF,23,LAL,8,6,257,61,129,.473,14,47,.298,47,82,.573,.527,18,22,.818,6,34,40,14,2,6,7,21,154
231,Skal Labissiere\labissk01,PF,22,SAC,3,0,15,2,5,.400,1,3,.333,1,2,.500,.500,0,0,,1,2,3,1,0,0,1,4,5
232,Jeremy Lamb\lambje01,SG,26,CHO,8,8,197,31,78,.397,11,28,.393,20,50,.400,.468,14,15,.933,6,23,29,12,9,5,3,19,87
233,Zach LaVine\lavinza01,SG,23,CHI,8,8,269,78,153,.510,19,50,.380,59,103,.573,.572,50,60,.833,2,38,40,29,6,5,31,24,225
234,Jake Layman\laymaja01,SF,24,POR,7,7,86,12,24,.500,4,11,.364,8,13,.615,.583,1,2,.500,2,9,11,3,2,1,3,4,29
235,T.J. Leaf\leaftj01,PF,21,IND,4,0,23,0,8,.000,0,2,.000,0,6,.000,.000,0,0,,2,2,4,2,0,1,2,1,0
236,Damion Lee\leeda03,SG,26,GSW,1,0,2,0,2,.000,0,1,.000,0,1,.000,.000,0,0,,0,0,0,0,0,0,0,1,0
237,Alex Len\lenal01,C,25,ATL,7,7,166,31,56,.554,4,12,.333,27,44,.614,.589,7,12,.583,11,30,41,12,3,10,10,19,73
238,Kawhi Leonard\leonaka01,SF,27,TOR,6,6,208,60,119,.504,12,27,.444,48,92,.522,.555,32,35,.914,6,41,47,19,12,3,9,12,164
239,Meyers Leonard\leoname01,C,26,POR,5,0,42,3,7,.429,1,4,.250,2,3,.667,.500,3,3,1.000,2,9,11,4,2,0,4,8,10
240,Jon Leuer\leuerjo01,PF,29,DET,1,0,6,1,2,.500,0,1,.000,1,1,1.000,.500,2,2,1.000,0,1,1,0,0,0,0,0,4
241,Caris LeVert\leverca01,SF,24,BRK,8,8,256,57,120,.475,10,36,.278,47,84,.560,.517,27,33,.818,6,31,37,38,8,2,21,21,151
242,Damian Lillard\lillada01,PG,28,POR,7,7,240,66,131,.504,20,53,.377,46,78,.590,.580,55,59,.932,5,29,34,42,4,2,16,10,207
243,Jeremy Lin\linje01,PG,30,ATL,7,0,102,13,38,.342,3,14,.214,10,24,.417,.382,12,14,.857,0,15,15,16,2,0,11,7,41
244,Shaun Livingston\livinsh01,PG,33,GSW,4,0,57,9,16,.563,0,0,,9,16,.563,.563,4,4,1.000,7,7,14,4,3,0,3,6,22
245,Zach Lofton\loftoza01,SG,26,DET,1,0,4,0,1,.000,0,1,.000,0,0,,.000,0,0,,0,0,0,0,1,0,1,0,0
246,Kevon Looney\looneke01,C,22,GSW,9,0,151,23,35,.657,0,0,,23,35,.657,.657,9,12,.750,20,21,41,14,3,5,7,18,55
247,Brook Lopez\lopezbr01,C,30,MIL,7,7,180,30,64,.469,17,44,.386,13,20,.650,.602,10,10,1.000,3,16,19,9,1,10,7,16,87
248,Robin Lopez\lopezro01,C,30,CHI,3,0,53,5,12,.417,0,0,,5,12,.417,.417,1,1,1.000,1,3,4,7,1,2,6,11,11
249,Kevin Love\loveke01,C,30,CLE,4,4,136,21,65,.323,7,24,.292,14,41,.341,.377,27,33,.818,10,44,54,14,1,1,10,14,76
250,Kyle Lowry\lowryky01,PG,32,TOR,8,8,279,52,101,.515,22,52,.423,30,49,.612,.624,22,29,.759,3,28,31,89,11,5,23,19,148
251,Jordan Loyd\loydjo01,G,25,TOR,1,0,2,0,0,,0,0,,0,0,,,0,0,,1,0,1,0,0,0,0,0,0
252,Timothe Luwawu-Cabarrot\luwawti01,SF,23,OKC,2,0,3,0,2,.000,0,1,.000,0,1,.000,.000,0,0,,0,1,1,0,0,0,0,1,0
253,Tyler Lydon\lydonty01,PF,22,DEN,2,0,4,1,1,1.000,0,0,,1,1,1.000,1.000,0,0,,1,0,1,0,0,0,0,0,2
254,Trey Lyles\lylestr01,PF,23,DEN,7,0,142,25,65,.385,3,21,.143,22,44,.500,.408,14,22,.636,6,28,34,14,7,2,16,14,67
255,Shelvin Mack\macksh01,PG,28,MEM,6,0,148,20,41,.488,4,9,.444,16,32,.500,.537,9,13,.692,1,11,12,24,5,0,6,11,53
256,Daryl Macon\maconda01,SG,23,DAL,1,0,1,0,0,,0,0,,0,0,,,0,0,,0,0,0,0,0,0,0,0,0
257,Ian Mahinmi\mahinia01,C,32,WAS,6,6,101,7,16,.438,0,2,.000,7,14,.500,.438,13,20,.650,9,16,25,3,4,3,4,21,27
258,Thon Maker\makerth01,C,21,MIL,3,0,41,7,12,.583,3,7,.429,4,5,.800,.708,2,4,.500,1,13,14,2,0,3,2,6,19
259,Boban Marjanovic\marjabo01,C,30,LAC,7,0,67,20,27,.741,0,1,.000,20,26,.769,.741,16,22,.727,7,21,28,2,2,5,7,13,56
260,Jarell Martin\martija01,PF,24,ORL,2,0,19,4,10,.400,0,4,.000,4,6,.667,.400,0,0,,0,4,4,2,0,0,0,0,8
261,Frank Mason\masonfr01,PG,24,SAC,7,0,113,21,47,.447,6,15,.400,15,32,.469,.511,8,11,.727,0,12,12,26,5,0,6,6,56
262,Wesley Matthews\matthwe02,SF,32,DAL,8,8,274,51,122,.418,24,69,.348,27,53,.509,.516,23,28,.821,6,15,21,19,6,0,12,22,149
263,Luc Mbah a Moute\mbahalu01,PF,32,LAC,4,0,61,8,18,.444,2,6,.333,6,12,.500,.500,2,5,.400,2,5,7,2,1,1,2,8,20
264,CJ McCollum\mccolcj01,SG,27,POR,7,7,224,48,117,.410,17,43,.395,31,74,.419,.483,22,26,.846,8,22,30,14,2,3,9,15,135
265,T.J. McConnell\mccontj01,PG,26,PHI,8,0,118,15,27,.556,0,2,.000,15,25,.600,.556,2,2,1.000,1,12,13,23,3,2,8,8,32
266,Doug McDermott\mcderdo01,SF,27,IND,8,0,140,20,37,.541,11,25,.440,9,12,.750,.689,6,7,.857,0,8,8,8,2,0,1,18,57
267,JaVale McGee\mcgeeja01,C,31,LAL,8,8,217,55,87,.632,1,2,.500,54,85,.635,.638,13,21,.619,24,36,60,10,8,26,14,29,124
268,Rodney McGruder\mcgruro01,SG,27,MIA,7,7,239,35,71,.493,17,34,.500,18,37,.486,.613,13,16,.813,7,35,42,26,6,3,10,23,100
269,Alfonzo McKinnie\mckinal01,SF,26,GSW,9,0,106,21,39,.538,8,15,.533,13,24,.542,.641,3,8,.375,12,23,35,2,2,2,4,16,53
270,Ben McLemore\mclembe01,SG,25,SAC,4,0,18,3,9,.333,3,8,.375,0,1,.000,.500,0,2,.000,0,0,0,1,0,0,0,0,9
271,Jordan McRae\mcraejo01,SG,27,WAS,3,0,21,1,7,.143,0,2,.000,1,5,.200,.143,0,0,,0,4,4,2,0,1,0,0,2
272,De'Anthony Melton\meltode01,PG,20,PHO,2,0,22,3,12,.250,1,6,.167,2,6,.333,.292,0,0,,0,2,2,1,3,1,2,5,7
273,Chimezie Metu\metuch01,PF,21,SAS,3,0,16,2,9,.222,0,1,.000,2,8,.250,.222,4,4,1.000,0,4,4,1,1,1,0,0,8
274,Khris Middleton\middlkh01,SF,27,MIL,7,7,214,45,91,.495,28,51,.549,17,40,.425,.648,27,31,.871,2,37,39,27,10,2,17,20,145
275,C.J. Miles\milescj01,SF,31,TOR,8,0,112,13,41,.317,6,26,.231,7,15,.467,.390,8,12,.667,2,11,13,5,2,4,5,14,40
276,Darius Miller\milleda01,SF,28,NOP,4,0,60,5,14,.357,4,11,.364,1,3,.333,.500,1,1,1.000,0,2,2,6,1,0,3,6,15
277,Patty Mills\millspa02,PG,30,SAS,7,0,187,19,46,.413,9,23,.391,10,23,.435,.511,9,11,.818,2,16,18,9,3,1,10,13,56
278,Paul Millsap\millspa01,PF,33,DEN,7,7,199,30,68,.441,4,14,.286,26,54,.481,.471,24,33,.727,17,39,56,9,7,11,13,16,88
279,Nikola Mirotic\mirotni01,PF,27,NOP,7,7,212,62,116,.534,20,51,.392,42,65,.646,.621,18,27,.667,18,51,69,9,6,3,8,17,162
280,Donovan Mitchell\mitchdo01,SG,22,UTA,7,7,246,62,139,.446,18,50,.360,44,89,.494,.511,21,27,.778,3,14,17,31,9,2,20,19,163
281,Malik Monk\monkma01,SG,20,CHO,8,0,191,34,87,.391,18,47,.383,16,40,.400,.494,11,11,1.000,2,14,16,16,4,4,8,17,97
282,Greg Monroe\monrogr01,C,28,TOR,2,0,9,1,5,.200,0,0,,1,5,.200,.200,0,0,,3,3,6,1,0,0,0,1,2
283,E'Twaun Moore\mooreet01,SG,29,NOP,7,7,224,41,78,.526,12,27,.444,29,51,.569,.603,10,13,.769,9,8,17,11,6,4,8,24,104
284,Marcus Morris\morrima03,PF,29,BOS,7,0,178,34,69,.493,15,31,.484,19,38,.500,.601,18,21,.857,4,48,52,7,3,1,12,24,101
285,Markieff Morris\morrima02,PF,29,WAS,6,6,154,27,53,.509,12,27,.444,15,26,.577,.623,10,13,.769,3,30,33,9,3,7,9,19,76
286,Monte Morris\morrimo01,PG,23,DEN,7,0,156,21,58,.362,6,15,.400,15,43,.349,.414,10,12,.833,4,12,16,26,8,0,4,10,58
287,Emmanuel Mudiay\mudiaem01,PG,22,NYK,1,0,2,0,0,,0,0,,0,0,,,0,0,,0,0,0,0,0,0,0,0,0
288,Jamal Murray\murraja01,PG,21,DEN,7,7,230,40,98,.408,10,36,.278,30,62,.484,.459,22,25,.880,5,29,34,23,10,4,11,16,112
289,Dzanan Musa\musadz01,SG,19,BRK,3,0,15,3,6,.500,0,2,.000,3,4,.750,.500,0,2,.000,1,1,2,1,2,0,1,0,6
290,Mike Muscala\muscami01,C,27,PHI,5,0,87,13,24,.542,7,18,.389,6,6,1.000,.688,8,8,1.000,6,16,22,4,0,4,4,10,41
291,Svi Mykhailiuk\mykhasv01,SF,21,LAL,4,0,53,3,12,.250,1,5,.200,2,7,.286,.292,1,2,.500,2,2,4,6,2,0,3,3,8
292,Abdel Nader\naderab01,SF,25,OKC,2,0,4,0,1,.000,0,0,,0,1,.000,.000,0,0,,0,0,0,0,1,0,0,1,0
293,Larry Nance\nancela02,C,26,CLE,5,0,104,19,37,.514,0,1,.000,19,36,.528,.514,10,14,.714,10,19,29,20,6,0,3,15,48
294,Shabazz Napier\napiesh01,PG,27,BRK,5,0,69,12,33,.364,8,18,.444,4,15,.267,.485,10,13,.769,0,3,3,8,4,0,5,3,42
295,Georges Niang\niangge01,PF,25,UTA,7,0,55,12,20,.600,8,14,.571,4,6,.667,.800,5,5,1.000,1,9,10,3,2,1,3,7,37
296,Nerlens Noel\noelne01,C,24,OKC,6,1,90,21,31,.677,0,0,,21,31,.677,.677,5,9,.556,17,21,38,3,7,5,1,23,47
297,Frank Ntilikina\ntilila01,PG,20,NYK,8,8,240,26,68,.382,12,31,.387,14,37,.378,.471,6,7,.857,1,17,18,29,9,2,12,21,70
298,James Nunnally\nunnaja01,SF,28,MIN,2,0,25,3,6,.500,2,4,.500,1,2,.500,.667,3,3,1.000,0,3,3,3,0,0,0,2,11
299,Jusuf Nurkic\nurkiju01,C,24,POR,7,7,168,40,79,.506,1,9,.111,39,70,.557,.513,19,24,.792,23,44,67,9,7,6,16,18,100
300,David Nwaba\nwabada01,SG,26,CLE,4,0,29,3,8,.375,1,2,.500,2,6,.333,.438,2,2,1.000,0,4,4,1,0,2,1,1,9
301,Royce O'Neale\onealro01,SF,25,UTA,7,0,96,11,24,.458,4,7,.571,7,17,.412,.542,2,2,1.000,2,17,19,5,3,0,6,10,28
302,Kyle O'Quinn\oquinky01,C,28,IND,6,0,43,11,20,.550,0,1,.000,11,19,.579,.550,6,6,1.000,6,11,17,7,1,4,4,9,28
303,Semi Ojeleye\ojelese01,PF,24,BOS,5,0,24,1,6,.167,0,3,.000,1,3,.333,.167,1,4,.250,2,1,3,0,0,0,0,3,3
304,Jahlil Okafor\okafoja01,C,23,NOP,4,1,41,9,20,.450,0,0,,9,20,.450,.450,6,6,1.000,6,6,12,1,0,0,5,6,24
305,Elie Okobo\okoboel01,PG,21,PHO,5,1,88,13,29,.448,5,14,.357,8,15,.533,.534,9,10,.900,2,7,9,15,1,0,7,15,40
306,Josh Okogie\okogijo01,SG,20,MIN,6,5,176,23,60,.383,5,24,.208,18,36,.500,.425,8,10,.800,10,22,32,8,10,4,9,15,59
307,Victor Oladipo\oladivi01,SG,26,IND,8,8,262,70,146,.479,19,46,.413,51,100,.510,.545,17,31,.548,4,43,47,35,12,3,19,18,176
308,Kelly Olynyk\olynyke01,PF,27,MIA,7,4,143,23,46,.500,8,27,.296,15,19,.789,.587,14,17,.824,7,14,21,17,5,3,7,15,68
309,Cedi Osman\osmande01,SF,23,CLE,7,7,227,33,86,.384,14,33,.424,19,53,.358,.465,12,17,.706,10,27,37,25,7,1,25,17,92
310,Kelly Oubre\oubreke01,SF,23,WAS,7,0,192,33,74,.446,14,36,.389,19,38,.500,.541,23,25,.920,7,30,37,4,4,4,12,16,103
311,Zaza Pachulia\pachuza01,C,34,DET,7,0,107,8,23,.348,0,0,,8,23,.348,.348,15,20,.750,14,18,32,14,6,3,4,20,31
312,Jabari Parker\parkeja01,PF,23,CHI,8,1,225,47,105,.448,10,30,.333,37,75,.493,.495,13,21,.619,11,40,51,17,5,4,14,14,117
313,Tony Parker\parketo01,PG,36,CHO,7,0,121,26,57,.456,2,5,.400,24,52,.462,.474,12,15,.800,0,10,10,37,1,0,9,9,66
314,Chandler Parsons\parsoch01,SF,30,MEM,3,3,46,7,17,.412,3,10,.300,4,7,.571,.500,0,0,,1,3,4,2,1,1,2,7,17
315,Patrick Patterson\pattepa01,PF,29,OKC,6,3,119,17,37,.459,8,21,.381,9,16,.563,.568,6,8,.750,7,15,22,0,3,3,3,8,48
316,Chris Paul\paulch01,PG,33,HOU,4,4,133,24,61,.393,8,23,.348,16,38,.421,.459,20,24,.833,4,19,23,33,7,0,11,12,76
317,Cameron Payne\payneca01,PG,24,CHI,8,7,184,29,65,.446,11,27,.407,18,38,.474,.531,12,12,1.000,6,11,17,27,5,2,14,17,81
318,Elfrid Payton\paytoel01,PG,24,NOP,5,5,144,24,48,.500,3,7,.429,21,41,.512,.531,7,11,.636,7,23,30,32,4,1,11,14,58
319,Theo Pinson\pinsoth01,SG,23,BRK,2,0,10,0,3,.000,0,2,.000,0,1,.000,.000,2,2,1.000,0,1,1,3,0,0,0,0,2
320,Mason Plumlee\plumlma01,C,28,DEN,7,0,117,24,35,.686,0,1,.000,24,34,.706,.686,5,16,.313,15,16,31,9,9,5,12,19,53
321,Miles Plumlee\plumlmi01,C,30,ATL,4,0,39,10,12,.833,0,0,,10,12,.833,.833,5,9,.556,6,7,13,6,2,0,4,4,25
322,Jakob Poeltl\poeltja01,C,23,SAS,4,3,42,4,7,.571,0,0,,4,7,.571,.571,0,0,,10,5,15,5,1,0,2,5,8
323,Quincy Pondexter\pondequ01,SF,30,SAS,4,0,33,4,8,.500,0,2,.000,4,6,.667,.500,2,2,1.000,3,6,9,1,5,0,1,4,10
324,Otto Porter\porteot01,SF,25,WAS,7,7,216,29,70,.414,8,29,.276,21,41,.512,.471,8,10,.800,6,31,37,8,11,5,4,13,74
325,Bobby Portis\portibo01,PF,23,CHI,4,4,113,17,41,.415,3,11,.273,14,30,.467,.451,5,9,.556,6,34,40,8,2,4,5,14,42
326,Dwight Powell\poweldw01,C,27,DAL,8,0,118,27,38,.711,1,7,.143,26,31,.839,.724,20,26,.769,11,21,32,9,7,3,9,22,75
327,Norman Powell\powelno01,SG,25,TOR,8,2,135,17,34,.500,7,16,.438,10,18,.556,.603,6,7,.857,1,16,17,8,4,1,6,12,47
328,Alex Poythress\poythal01,PF,25,ATL,4,0,72,8,15,.533,2,5,.400,6,10,.600,.600,3,9,.333,6,9,15,6,2,1,4,14,21
329,Zhou Qi\qizh01,F-C,23,HOU,1,0,1,1,1,1.000,0,0,,1,1,1.000,1.000,0,0,,0,0,0,0,0,0,0,0,2
330,Ivan Rabb\rabbiv01,PF,21,MEM,2,0,23,3,5,.600,0,1,.000,3,4,.750,.600,2,3,.667,2,6,8,3,1,1,4,3,8
331,Julius Randle\randlju01,C,24,NOP,7,1,161,43,80,.538,4,12,.333,39,68,.574,.563,27,37,.730,12,43,55,14,5,4,17,26,117
332,J.J. Redick\redicjj01,SG,34,PHI,8,0,243,49,124,.395,30,77,.390,19,47,.404,.516,20,21,.952,3,25,28,26,4,1,8,11,148
333,Josh Richardson\richajo01,SF,25,MIA,7,7,239,47,116,.405,19,53,.358,28,63,.444,.487,21,24,.875,7,24,31,19,7,7,15,22,134
334,Malachi Richardson\richama01,SG,23,TOR,5,0,29,2,9,.222,2,9,.222,0,0,,.333,1,2,.500,1,3,4,0,0,0,1,4,7
335,Austin Rivers\riverau01,SG,26,WAS,7,0,164,19,48,.396,9,28,.321,10,20,.500,.490,5,7,.714,2,10,12,14,3,4,11,19,52
336,Duncan Robinson\robindu01,SF,24,MIA,1,0,10,1,3,.333,1,3,.333,0,0,,.500,0,0,,0,4,4,0,1,0,0,0,3
337,Glenn Robinson\robingl02,SF,25,DET,6,0,77,9,19,.474,1,5,.200,8,14,.571,.500,4,5,.800,2,7,9,0,2,1,2,3,23
338,Jerome Robinson\robinje01,SG,21,LAC,3,0,16,4,8,.500,1,2,.500,3,6,.500,.563,0,0,,0,1,1,0,0,0,0,3,9
339,Mitchell Robinson\robinmi01,C,20,NYK,6,3,85,11,18,.611,0,0,,11,18,.611,.611,3,6,.500,11,7,18,1,3,4,2,8,25
340,Rajon Rondo\rondora01,PG,32,LAL,5,2,139,24,45,.533,6,13,.462,18,32,.563,.600,2,2,1.000,4,17,21,37,5,0,13,16,56
341,Derrick Rose\rosede01,PG,30,MIN,8,1,240,56,127,.441,9,26,.346,47,101,.465,.476,29,38,.763,11,21,32,40,7,2,15,13,150
342,Terrence Ross\rosste01,SG,27,ORL,7,0,167,32,84,.381,13,42,.310,19,42,.452,.458,7,8,.875,3,14,17,14,9,4,8,17,84
343,Terry Rozier\roziete01,PG,24,BOS,7,0,160,20,51,.392,8,20,.400,12,31,.387,.471,7,8,.875,2,26,28,15,7,2,3,10,55
344,Ricky Rubio\rubiori01,PG,28,UTA,7,7,206,19,61,.311,8,25,.320,11,36,.306,.377,17,19,.895,2,17,19,50,8,2,22,19,63
345,D'Angelo Russell\russeda01,PG,22,BRK,8,8,226,43,106,.406,21,50,.420,22,56,.393,.505,14,17,.824,4,26,30,44,6,4,24,14,121
346,Domantas Sabonis\sabondo01,C,22,IND,7,0,156,41,58,.707,1,1,1.000,40,57,.702,.716,18,23,.783,23,44,67,15,5,5,17,20,101
347,Dario Saric\saricda01,PF,24,PHI,8,8,248,30,86,.349,11,47,.234,19,39,.487,.413,13,16,.813,16,44,60,18,4,2,15,24,84
348,Tomas Satoransky\satorto01,SG,27,WAS,7,0,91,8,22,.364,3,5,.600,5,17,.294,.432,12,12,1.000,2,11,13,14,1,1,3,10,31
349,Dennis Schroder\schrode01,PG,25,OKC,6,2,172,28,83,.337,6,21,.286,22,62,.355,.373,18,22,.818,3,20,23,38,5,1,16,23,80
350,Mike Scott\scottmi01,PF,30,LAC,7,0,80,11,19,.579,5,9,.556,6,10,.600,.711,0,0,,1,11,12,7,3,0,2,12,27
351,Wayne Selden\seldewa01,SG,24,MEM,6,0,94,17,33,.515,7,16,.438,10,17,.588,.621,5,5,1.000,2,4,6,6,4,0,8,9,46
352,Collin Sexton\sextoco01,PG,20,CLE,7,0,169,27,64,.422,1,7,.143,26,57,.456,.430,29,32,.906,6,13,19,16,3,1,14,16,84
353,Landry Shamet\shamela01,PG,21,PHI,8,1,146,15,43,.349,11,31,.355,4,12,.333,.477,5,6,.833,2,8,10,7,4,1,3,8,46
354,Iman Shumpert\shumpim01,SG,28,SAC,7,4,132,21,42,.500,12,25,.480,9,17,.529,.643,6,7,.857,1,16,17,8,5,3,5,13,60
355,Pascal Siakam\siakapa01,PF,24,TOR,8,7,208,38,64,.594,3,13,.231,35,51,.686,.617,8,13,.615,11,45,56,18,10,5,14,23,87
356,Ben Simmons\simmobe01,PG,22,PHI,7,7,215,37,80,.463,0,0,,37,80,.463,.463,22,36,.611,21,52,73,56,7,5,26,23,96
357,Jonathon Simmons\simmojo02,SG,29,ORL,6,0,144,17,59,.288,4,21,.190,13,38,.342,.322,13,16,.813,6,13,19,16,2,2,9,15,51
358,Anfernee Simons\simonan01,G,19,POR,1,0,1,0,0,,0,0,,0,0,,,0,0,,0,0,0,0,0,0,0,0,0
359,Marcus Smart\smartma01,SG,24,BOS,7,0,158,11,32,.344,3,17,.176,8,15,.533,.391,11,15,.733,4,15,19,28,7,2,10,18,36
360,Dennis Smith\smithde03,PG,21,DAL,7,7,209,44,102,.431,9,29,.310,35,73,.479,.475,12,16,.750,4,12,16,30,8,3,21,19,109
361,Ish Smith\smithis01,PG,30,DET,7,0,201,33,66,.500,12,26,.462,21,40,.525,.591,4,5,.800,1,16,17,23,2,2,9,20,82
362,J.R. Smith\smithjr01,SG,33,CLE,4,0,48,3,13,.231,0,6,.000,3,7,.429,.231,4,4,1.000,0,4,4,1,3,0,3,3,10
363,Jason Smith\smithja02,C,32,WAS,5,1,79,8,20,.400,1,2,.500,7,18,.389,.425,7,8,.875,9,17,26,7,1,4,4,14,24
364,Tony Snell\snellto01,SG,27,MIL,7,0,116,18,34,.529,9,23,.391,9,11,.818,.662,1,3,.333,2,9,11,6,2,2,1,8,46
365,Ray Spalding\spaldra01,PF,21,DAL,1,0,1,0,0,,0,0,,0,0,,,0,0,,0,0,0,0,0,0,0,0,0
366,Omari Spellman\spellom01,PF,21,ATL,6,0,106,16,37,.432,7,17,.412,9,20,.450,.527,5,8,.625,12,15,27,5,3,1,6,12,44
367,Nik Stauskas\stausni01,SG,25,POR,7,0,157,23,52,.442,13,28,.464,10,24,.417,.567,12,12,1.000,4,17,21,14,2,1,7,8,71
368,Lance Stephenson\stephla01,SG,28,LAL,8,0,153,36,68,.529,9,20,.450,27,48,.563,.596,5,7,.714,8,26,34,21,9,0,11,18,86
369,Edmond Sumner\sumneed01,PG,23,IND,5,0,20,1,4,.250,0,1,.000,1,3,.333,.250,0,2,.000,1,0,1,1,1,0,1,3,2
370,Caleb Swanigan\swanica01,PF,21,POR,3,0,42,5,12,.417,0,0,,5,12,.417,.417,3,3,1.000,6,15,21,1,1,0,5,8,13
371,Jayson Tatum\tatumja01,SF,20,BOS,7,7,228,40,99,.404,8,28,.286,32,71,.451,.444,28,32,.875,7,50,57,16,5,2,13,19,116
372,Jeff Teague\teaguje01,PG,30,MIN,7,7,212,28,78,.359,7,22,.318,21,56,.375,.404,26,28,.929,1,16,17,48,6,1,13,18,89
373,Garrett Temple\templga01,SG,32,MEM,6,6,182,26,58,.448,16,31,.516,10,27,.370,.586,18,21,.857,3,19,22,8,5,3,7,13,86
374,Milos Teodosic\teodomi01,PG,31,LAC,3,0,35,5,6,.833,4,5,.800,1,1,1.000,1.167,0,0,,1,6,7,8,1,1,5,4,14
375,Daniel Theis\theisda01,C,26,BOS,5,0,61,13,23,.565,2,5,.400,11,18,.611,.609,2,3,.667,7,10,17,4,0,1,4,13,30
376,Lance Thomas\thomala01,PF,30,NYK,8,5,137,8,29,.276,4,13,.308,4,16,.250,.345,6,7,.857,4,14,18,3,5,2,6,17,26
377,Klay Thompson\thompkl01,SG,28,GSW,9,9,295,69,157,.439,20,64,.313,49,93,.527,.503,18,21,.857,5,33,38,13,6,5,16,21,176
378,Tristan Thompson\thomptr01,C,27,CLE,7,7,186,24,52,.462,0,0,,24,52,.462,.462,5,10,.500,32,33,65,12,5,3,10,17,53
379,Anthony Tolliver\tollian01,PF,33,MIN,8,0,167,18,36,.500,15,31,.484,3,5,.600,.708,4,7,.571,3,22,25,5,4,7,6,19,55
380,Karl-Anthony Towns\townska01,C,23,MIN,8,8,258,49,112,.438,18,40,.450,31,72,.431,.518,35,38,.921,23,62,85,19,6,18,23,31,151
381,Allonzo Trier\trieral01,SG,23,NYK,8,0,170,26,54,.481,5,11,.455,21,43,.488,.528,17,19,.895,5,17,22,10,2,3,12,6,74
382,P.J. Tucker\tuckepj01,PF,33,HOU,6,6,214,19,46,.413,13,32,.406,6,14,.429,.554,3,6,.500,11,20,31,9,14,5,5,17,54
383,Evan Turner\turneev01,SF,30,POR,7,0,171,29,56,.518,1,5,.200,28,51,.549,.527,6,9,.667,3,30,33,29,8,3,15,19,65
384,Myles Turner\turnemy01,C,22,IND,8,8,216,40,80,.500,2,10,.200,38,70,.543,.513,10,15,.667,14,29,43,12,3,17,9,22,92
385,Ekpe Udoh\udohek01,C,31,UTA,5,0,30,0,0,,0,0,,0,0,,,4,6,.667,1,5,6,3,0,2,2,5,4
386,Tyler Ulis\ulisty01,PG,23,CHI,1,0,1,0,0,,0,0,,0,0,,,0,0,,0,0,0,0,0,0,0,0,0
387,Jonas Valanciunas\valanjo01,C,26,TOR,8,3,146,41,78,.526,3,10,.300,38,68,.559,.545,24,27,.889,20,38,58,10,4,5,8,24,109
388,Fred VanVleet\vanvlfr01,PG,24,TOR,4,0,99,18,43,.419,4,16,.250,14,27,.519,.465,6,11,.545,2,10,12,21,1,0,5,9,46
389,Noah Vonleh\vonleno01,PF,23,NYK,8,3,169,22,39,.564,2,5,.400,20,34,.588,.590,21,28,.750,20,48,68,17,6,8,9,18,67
390,Nikola Vucevic\vucevni01,C,28,ORL,7,7,201,53,93,.570,7,11,.636,46,82,.561,.608,17,20,.850,23,53,76,30,10,7,17,16,130
391,Dwyane Wade\wadedw01,SG,37,MIA,7,0,176,34,81,.420,13,29,.448,21,52,.404,.500,11,15,.733,11,20,31,21,3,3,17,16,92
392,Kemba Walker\walkeke02,PG,28,CHO,8,8,271,81,175,.463,36,87,.414,45,88,.511,.566,43,51,.843,3,30,33,48,6,3,15,12,241
393,John Wall\walljo01,PG,28,WAS,7,7,237,52,118,.441,7,32,.219,45,86,.523,.470,35,49,.714,6,17,23,50,16,9,27,20,146
394,Tyrone Wallace\wallaty01,PG,24,LAC,4,0,15,2,5,.400,0,0,,2,5,.400,.400,1,2,.500,0,1,1,1,0,0,1,1,5
395,Taurean Waller-Prince\princta02,SF,24,ATL,7,7,202,39,98,.398,17,47,.362,22,51,.431,.485,22,23,.957,2,33,35,20,9,2,27,27,117
396,Brad Wanamaker\wanambr01,PG,29,BOS,2,0,6,2,4,.500,0,1,.000,2,3,.667,.500,2,2,1.000,0,1,1,0,0,0,1,0,6
397,T.J. Warren\warretj01,SF,25,PHO,7,1,175,44,86,.512,12,25,.480,32,61,.525,.581,12,13,.923,8,17,25,10,4,5,8,13,112
398,Yuta Watanabe\watanyu01,SG,24,MEM,1,0,5,0,0,,0,0,,0,0,,,2,2,1.000,0,2,2,0,0,0,1,0,2
399,Thomas Welsh\welshth01,C,22,DEN,3,0,7,0,1,.000,0,1,.000,0,0,,.000,0,0,,0,2,2,2,0,0,0,1,0
400,Russell Westbrook\westbru01,PG,30,OKC,4,4,132,39,81,.481,2,14,.143,37,67,.552,.494,20,33,.606,6,34,40,31,7,1,19,14,100
401,Hassan Whiteside\whiteha01,C,29,MIA,7,7,207,35,71,.493,0,3,.000,35,68,.515,.493,21,38,.553,26,83,109,0,3,21,15,21,91
402,Andrew Wiggins\wiggian01,SF,23,MIN,5,5,147,30,68,.441,8,21,.381,22,47,.468,.500,14,17,.824,3,15,18,9,7,1,8,14,82
403,C.J. Williams\willicj01,SG,28,MIN,3,0,19,1,3,.333,0,2,.000,1,1,1.000,.333,0,0,,0,0,0,0,0,0,2,4,2
404,Johnathan Williams\willijo04,PF,23,LAL,6,0,85,11,19,.579,0,0,,11,19,.579,.579,1,5,.200,11,10,21,4,1,3,2,19,23
405,Kenrich Williams\willike04,SF,24,NOP,2,0,15,0,2,.000,0,1,.000,0,1,.000,.000,0,0,,0,2,2,0,0,0,0,3,0
406,Lou Williams\willilo02,SG,32,LAC,7,0,169,37,86,.430,10,29,.345,27,57,.474,.488,33,35,.943,2,14,16,21,4,1,18,7,117
407,Marvin Williams\willima02,PF,32,CHO,8,8,189,21,58,.362,7,33,.212,14,25,.560,.422,5,8,.625,8,32,40,9,4,13,4,12,54
408,Robert Williams\williro04,C,21,BOS,3,0,12,1,1,1.000,0,0,,1,1,1.000,1.000,0,0,,2,0,2,1,0,3,0,1,2
409,Troy Williams\willitr02,SF,24,SAC,2,0,46,6,10,.600,3,6,.500,3,4,.750,.750,0,0,,0,6,6,1,1,2,0,6,15
410,Justise Winslow\winslju01,PF,22,MIA,3,0,73,8,24,.333,1,5,.200,7,19,.368,.354,7,11,.636,4,9,13,8,5,2,3,7,24
411,Christian Wood\woodch01,PF,23,MIL,3,0,15,1,4,.250,1,2,.500,0,2,.000,.375,3,4,.750,0,3,3,0,0,0,1,2,6
412,Delon Wright\wrighde01,PG,26,TOR,3,0,32,4,14,.286,1,3,.333,3,11,.273,.321,2,2,1.000,1,5,6,2,1,1,0,4,11
413,Guerschon Yabusele\yabusgu01,PF,23,BOS,5,0,18,2,6,.333,0,3,.000,2,3,.667,.333,0,0,,2,3,5,0,0,1,0,1,4
414,Thaddeus Young\youngth01,PF,30,IND,8,8,243,39,72,.542,3,9,.333,36,63,.571,.563,8,15,.533,12,26,38,11,13,5,7,18,89
415,Trae Young\youngtr01,PG,20,ATL,7,7,220,45,105,.429,16,47,.340,29,58,.500,.505,28,37,.757,3,17,20,46,4,2,21,15,134
416,Cody Zeller\zelleco01,C,26,CHO,8,8,176,30,49,.612,1,3,.333,29,46,.630,.622,16,16,1.000,17,29,46,12,5,5,8,21,77
417,Ante Zizic\zizican01,C,22,CLE,6,0,39,7,11,.636,0,0,,7,11,.636,.636,7,10,.700,5,6,11,4,1,0,3,5,21
418,Ivica Zubac\zubaciv01,C,21,LAL,2,0,7,0,2,.000,0,0,,0,2,.000,.000,0,0,,2,1,3,1,0,1,0,5,0
