1,Alex Abrines\abrinal01,SG,25,OKC,8,0,174,22,54,.407,14,40,.350,8,14,.571,.537,4,5,.800,1,9,10,6,7,3,3,18,62
2,Jaylen Adams\adamsja01,PG,22,ATL,4,0,13,1,4,.250,1,4,.250,0,0,,.375,0,0,,0,2,2,1,0,1,0,0,3
3,Steven Adams\adamsst01,C,25,OKC,7,7,230,37,67,.552,0,0,,37,67,.552,.552,20,36,.556,33,41,74,9,11,9,10,18,94
4,Bam Adebayo\adebaba01,C,21,MIA,7,0,124,18,37,.486,0,2,.000,18,35,.514,.486,16,23,.696,15,32,47,7,3,2,10,16,52
5,DeVaughn Akoon-Purcell\akoonde01,SG,25,DEN,2,0,5,0,2,.000,0,1,.000,0,1,.000,.000,1,2,.500,1,0,1,0,0,0,0,1,1
6,LaMarcus Aldridge\aldrila01,C,33,SAS,7,7,247,54,122,.443,0,4,.000,54,118,.458,.443,36,48,.750,30,34,64,22,4,9,12,14,144
7,Grayson Allen\allengr01,SG,23,UTA,6,1,68,9,20,.450,4,12,.333,5,8,.625,.550,9,10,.900,0,2,2,3,0,0,2,7,31
8,Jarrett Allen\allenja01,C,20,BRK,9,9,238,41,68,.603,2,8,.250,39,60,.650,.618,15,28,.536,18,49,67,15,4,17,14,17,99
9,Al-Farouq Aminu\aminual01,PF,28,POR,8,8,232,23,59,.390,8,29,.276,15,30,.500,.458,16,18,.889,9,61,70,3,6,2,6,18,70
10,Kyle Anderson\anderky01,SF,25,MEM,7,4,169,10,30,.333,0,2,.000,10,28,.357,.333,6,12,.500,9,32,41,15,9,2,10,14,26
11,Ryan Anderson\anderry01,PF,30,PHO,8,6,172,16,46,.348,6,24,.250,10,22,.455,.413,11,14,.786,11,17,28,13,2,0,7,10,49
12,Ike Anigbogu\anigbik01,C,20,IND,1,0,3,0,2,.000,0,0,,0,2,.000,.000,0,0,,0,1,1,0,0,1,1,0,0
13,Giannis Antetokounmpo\antetgi01,PF,24,MIL,7,7,220,73,140,.521,1,17,.059,72,123,.585,.525,36,51,.706,20,76,96,36,7,10,34,25,183
14,Carmelo Anthony\anthoca01,PF,34,HOU,7,2,218,37,87,.425,18,44,.409,19,43,.442,.529,15,21,.714,6,31,37,4,4,7,7,25,107
15,OG Anunoby\anunoog01,SF,21,TOR,6,1,142,16,36,.444,6,20,.300,10,16,.625,.528,0,0,,4,14,18,3,3,2,4,16,38
16,Ryan Arcidiacono\arcidry01,PG,24,CHI,8,0,201,17,35,.486,12,25,.480,5,10,.500,.657,5,5,1.000,1,13,14,44,6,1,6,17,51
17,Trevor Ariza\arizatr01,SF,33,PHO,8,8,262,26,77,.338,15,46,.326,11,31,.355,.435,14,15,.933,6,34,40,29,6,1,13,11,81
18,D.J. Augustin\augusdj01,PG,31,ORL,8,8,210,24,65,.369,12,30,.400,12,35,.343,.462,13,14,.929,6,13,19,36,3,0,8,9,73
19,Deandre Ayton\aytonde01,C,20,PHO,8,8,253,60,96,.625,0,0,,60,96,.625,.625,15,20,.750,22,66,88,25,4,6,11,23,135
20,Dwayne Bacon\bacondw01,SG,23,CHO,3,0,21,4,8,.500,2,4,.500,2,4,.500,.625,4,4,1.000,0,2,2,2,1,0,0,2,14
21,Marvin Bagley\baglema01,PF,19,SAC,9,0,210,46,83,.554,5,9,.556,41,74,.554,.584,20,33,.606,27,35,62,10,7,10,21,21,117
22,Ron Baker\bakerro01,SG,25,NYK,6,0,79,1,10,.100,0,7,.000,1,3,.333,.100,3,4,.750,0,4,4,7,3,0,2,13,5
23,Wade Baldwin\baldwwa01,PG,22,POR,2,0,5,0,3,.000,0,1,.000,0,2,.000,.000,0,0,,0,2,2,0,0,0,2,0,0
24,Lonzo Ball\balllo01,PG,21,LAL,8,6,224,30,65,.462,16,39,.410,14,26,.538,.585,5,9,.556,6,30,36,36,9,0,11,15,81
25,Mohamed Bamba\bambamo01,C,20,ORL,8,0,164,20,39,.513,5,16,.313,15,23,.652,.577,2,7,.286,10,33,43,11,2,14,5,9,47
26,J.J. Barea\bareajo01,PG,34,DAL,9,0,165,26,83,.313,6,26,.231,20,57,.351,.349,8,14,.571,5,15,20,57,6,0,12,14,66
27,Harrison Barnes\barneha02,SF,26,DAL,5,5,160,26,74,.351,8,27,.296,18,47,.383,.405,12,18,.667,2,18,20,7,4,2,7,12,72
28,Will Barton\bartowi01,SG,28,DEN,2,2,54,12,21,.571,5,9,.556,7,12,.583,.690,4,4,1.000,0,10,10,6,1,2,3,5,33
29,Keita Bates-Diop\bateske01,SF,23,MIN,1,0,6,0,1,.000,0,0,,0,1,.000,.000,0,0,,0,1,1,0,0,0,0,0,0
30,Nicolas Batum\batumni01,SF,30,CHO,9,9,307,36,79,.456,17,42,.405,19,37,.514,.563,7,9,.778,9,48,57,33,11,7,20,15,96
31,Aron Baynes\baynear01,C,32,BOS,5,1,73,12,30,.400,5,15,.333,7,15,.467,.483,8,11,.727,10,13,23,6,0,1,2,10,37
32,Kent Bazemore\bazemke01,SG,29,ATL,8,8,235,45,95,.474,14,43,.326,31,52,.596,.547,15,23,.652,8,29,37,19,12,8,17,27,119
33,Bradley Beal\bealbr01,SG,25,WAS,8,8,264,68,144,.472,26,67,.388,42,77,.545,.563,23,31,.742,2,30,32,30,8,6,19,26,185
34,Malik Beasley\beaslma01,SG,22,DEN,8,0,147,21,48,.438,5,20,.250,16,28,.571,.490,0,0,,2,17,19,7,3,1,6,10,47
35,Michael Beasley\beaslmi01,PF,30,LAL,3,0,10,1,3,.333,0,0,,1,3,.333,.333,1,2,.500,1,2,3,0,0,0,2,3,3
36,Marco Belinelli\belinma01,SG,32,SAS,7,0,151,26,68,.382,10,33,.303,16,35,.457,.456,16,18,.889,1,14,15,10,5,1,7,11,78
37,Jordan Bell\belljo01,C,24,GSW,9,0,95,6,11,.545,0,0,,6,11,.545,.545,5,7,.714,5,15,20,4,4,10,4,11,17
38,DeAndre' Bembry\bembrde01,SG,24,ATL,8,0,200,27,64,.422,9,19,.474,18,45,.400,.492,8,18,.444,5,38,43,21,11,5,17,18,71
39,Dragan Bender\bendedr01,PF,21,PHO,4,0,14,2,4,.500,0,1,.000,2,3,.667,.500,0,0,,2,3,5,0,0,0,2,1,4
40,Davis Bertans\bertada01,PF,26,SAS,7,1,110,12,24,.500,10,19,.526,2,5,.400,.708,4,4,1.000,4,11,15,9,2,2,3,6,38
41,Patrick Beverley\beverpa01,PG,30,LAC,9,9,216,17,59,.288,8,32,.250,9,27,.333,.356,9,13,.692,8,33,41,39,7,2,13,35,51
42,Khem Birch\birchkh01,C,26,ORL,3,0,22,3,5,.600,0,0,,3,5,.600,.600,0,0,,0,6,6,0,2,0,0,0,6
43,Bismack Biyombo\biyombi01,C,26,CHO,4,0,45,4,8,.500,0,0,,4,8,.500,.500,2,5,.400,4,9,13,1,0,7,2,8,10
44,Nemanja Bjelica\bjeline01,PF,30,SAC,9,9,244,53,90,.589,21,38,.553,32,52,.615,.706,13,19,.684,10,44,54,27,12,8,12,27,140
45,Antonio Blakeney\blakean01,SG,22,CHI,9,0,163,43,78,.551,16,27,.593,27,51,.529,.654,10,18,.556,1,20,21,4,1,2,4,8,112
46,Eric Bledsoe\bledser01,PG,29,MIL,8,8,227,39,85,.459,12,34,.353,27,51,.529,.529,15,19,.789,10,24,34,55,7,7,16,22,105
47,Bojan Bogdanovic\bogdabo02,SF,29,IND,9,9,270,44,85,.518,18,34,.529,26,51,.510,.624,15,18,.833,2,30,32,7,2,0,16,11,121
48,Jonah Bolden\boldejo01,PF,23,PHI,4,0,15,2,6,.333,0,4,.000,2,2,1.000,.333,1,2,.500,0,2,2,1,0,1,1,2,5
49,Devin Booker\bookede01,SG,22,PHO,5,5,173,44,91,.484,14,38,.368,30,53,.566,.560,27,34,.794,2,20,22,33,4,1,25,16,129
50,Chris Boucher\bouchch01,PF,26,TOR,1,0,2,1,2,.500,0,1,.000,1,1,1.000,.500,4,6,.667,2,0,2,0,0,1,0,0,6
51,Avery Bradley\bradlav01,SG,28,LAC,9,9,247,28,80,.350,7,27,.259,21,53,.396,.394,1,1,1.000,7,10,17,14,6,3,14,25,64
52,Mikal Bridges\bridgmi01,SF,22,PHO,8,0,129,18,40,.450,6,19,.316,12,21,.571,.525,9,11,.818,2,12,14,8,9,0,6,13,51
53,Miles Bridges\bridgmi02,SF,20,CHO,8,0,152,25,44,.568,7,19,.368,18,25,.720,.648,3,7,.429,4,24,28,10,6,3,6,11,60
54,Isaiah Briscoe\briscis01,PG,22,ORL,4,0,29,4,11,.364,1,1,1.000,3,10,.300,.409,1,3,.333,0,2,2,5,0,0,1,3,10
55,Ryan Broekhoff\broekry01,SG,28,DAL,5,0,15,2,8,.250,2,8,.250,0,0,,.375,0,0,,0,2,2,0,0,0,0,1,6
56,Malcolm Brogdon\brogdma01,SG,26,MIL,8,8,244,40,78,.513,12,27,.444,28,51,.549,.590,15,15,1.000,6,25,31,29,4,2,16,18,107
57,Dillon Brooks\brookdi01,SF,23,MEM,7,0,125,12,34,.353,3,11,.273,9,23,.391,.397,7,10,.700,3,11,14,8,6,3,5,21,34
58,MarShon Brooks\brookma01,SG,30,MEM,6,0,74,13,27,.481,3,11,.273,10,16,.625,.537,7,9,.778,1,8,9,4,1,0,3,6,36
59,Bruce Brown\brownbr01,SG,22,DET,5,1,74,9,24,.375,1,10,.100,8,14,.571,.396,6,9,.667,2,5,7,2,3,2,3,15,25
60,Jaylen Brown\brownja02,SG,22,BOS,8,7,204,27,75,.360,9,28,.321,18,47,.383,.420,13,21,.619,10,19,29,13,4,3,9,22,76
61,Lorenzo Brown\brownlo01,PG,28,TOR,7,0,64,8,23,.348,2,10,.200,6,13,.462,.391,0,0,,1,7,8,8,3,2,5,6,18
62,Sterling Brown\brownst02,SG,23,MIL,5,0,26,2,8,.250,0,3,.000,2,5,.400,.250,0,0,,2,7,9,1,0,0,3,2,4
63,Troy Brown\browntr01,SF,19,WAS,3,0,23,5,10,.500,2,3,.667,3,7,.429,.600,2,2,1.000,2,6,8,0,2,0,1,1,14
64,Jalen Brunson\brunsja01,PG,22,DAL,9,1,143,16,48,.333,6,22,.273,10,26,.385,.396,4,4,1.000,0,12,12,12,3,0,5,9,42
65,Thomas Bryant\bryanth01,C,21,WAS,2,0,20,4,12,.333,0,4,.000,4,8,.500,.333,5,5,1.000,4,3,7,1,0,0,1,1,13
66,Reggie Bullock\bullore01,SG,27,DET,6,6,171,20,61,.328,7,28,.250,13,33,.394,.385,13,15,.867,2,12,14,12,1,2,6,10,60
67,Trey Burke\burketr01,PG,26,NYK,9,5,177,34,86,.395,9,25,.360,25,61,.410,.448,7,11,.636,7,12,19,31,4,0,9,9,84
68,Alec Burks\burksal01,SG,27,UTA,5,0,55,8,21,.381,4,8,.500,4,13,.308,.476,10,11,.909,0,7,7,5,2,1,2,3,30
69,Deonte Burton\burtode02,SG,25,OKC,3,0,13,2,6,.333,1,2,.500,1,4,.250,.417,0,0,,0,1,1,0,0,1,0,1,5
70,Jimmy Butler\butleji01,SG,29,MIN,7,7,238,56,114,.491,12,33,.364,44,81,.543,.544,32,39,.821,12,23,35,25,18,8,9,11,156
71,Jose Calderon\caldejo01,PG,37,DET,4,0,42,4,10,.400,3,7,.429,1,3,.333,.550,2,2,1.000,1,3,4,2,2,1,1,6,13
72,Kentavious Caldwell-Pope\caldwke01,SG,25,LAL,8,3,163,15,42,.357,4,18,.222,11,24,.458,.405,13,14,.929,1,14,15,3,3,1,5,6,47
73,Isaiah Canaan\canaais01,PG,27,PHO,7,7,185,25,54,.463,8,26,.308,17,28,.607,.537,6,7,.857,3,19,22,21,4,0,13,17,64
74,Clint Capela\capelca01,C,24,HOU,7,7,233,49,80,.613,0,0,,49,80,.613,.613,12,26,.462,30,50,80,15,3,13,14,16,110
75,Vince Carter\cartevi01,SF,42,ATL,8,8,166,20,51,.392,14,35,.400,6,16,.375,.529,6,7,.857,2,18,20,8,5,3,7,15,60
76,Wendell Carter\cartewe01,C,19,CHI,9,9,228,39,88,.443,3,9,.333,36,79,.456,.460,16,22,.727,21,37,58,27,6,15,12,27,97
77,Michael Carter-Williams\cartemi01,PG,27,HOU,7,1,97,13,36,.361,2,10,.200,11,26,.423,.389,7,16,.438,2,8,10,14,7,4,8,17,35
78,Omri Casspi\casspom01,SF,30,MEM,6,0,80,13,23,.565,3,7,.429,10,16,.625,.630,8,15,.533,3,14,17,8,3,0,2,5,37
79,Willie Cauley-Stein\caulewi01,C,25,SAC,9,9,267,66,116,.569,0,0,,66,116,.569,.569,19,36,.528,24,54,78,21,11,3,10,24,151
80,Tyson Chandler\chandty01,C,36,PHO,7,0,89,8,12,.667,0,0,,8,12,.667,.667,10,18,.556,7,32,39,6,2,1,7,21,26
81,Marquese Chriss\chrisma01,PF,21,HOU,2,0,11,2,7,.286,0,3,.000,2,4,.500,.286,0,0,,0,2,2,0,0,1,1,1,4
82,Gary Clark\clarkga01,PF,24,HOU,6,0,47,6,17,.353,5,15,.333,1,2,.500,.500,0,0,,2,6,8,1,1,2,1,8,17
83,Ian Clark\clarkia01,SG,27,NOP,7,0,94,14,24,.583,7,13,.538,7,11,.636,.729,4,4,1.000,0,6,6,4,1,0,3,14,39
84,Jordan Clarkson\clarkjo01,SG,26,CLE,8,0,180,53,106,.500,9,31,.290,44,75,.587,.542,14,15,.933,7,16,23,8,4,2,10,13,129
85,Zach Collins\colliza01,C,21,POR,8,0,171,31,51,.608,8,16,.500,23,35,.657,.686,17,20,.850,9,25,34,11,4,15,10,30,87
86,Darren Collison\collida01,PG,31,IND,9,9,243,35,76,.461,5,18,.278,30,58,.517,.493,12,15,.800,3,17,20,42,14,0,14,16,87
87,Mike Conley\conlemi01,PG,31,MEM,7,7,221,44,115,.383,14,45,.311,30,70,.429,.443,40,47,.851,7,20,27,42,9,1,10,15,142
88,Pat Connaughton\connapa01,SG,26,MIL,5,0,66,10,27,.370,5,15,.333,5,12,.417,.463,2,4,.500,2,22,24,4,1,1,3,6,27
89,Quinn Cook\cookqu01,PG,25,GSW,7,0,72,12,28,.429,4,12,.333,8,16,.500,.500,6,7,.857,1,5,6,5,2,0,5,7,34
90,Robert Covington\covinro01,SF,28,PHI,9,9,313,40,90,.444,26,58,.448,14,32,.438,.589,12,17,.706,6,46,52,10,20,17,15,29,118
91,Allen Crabbe\crabbal01,SG,26,BRK,8,0,182,16,61,.262,12,40,.300,4,21,.190,.361,12,16,.750,2,30,32,11,1,4,10,21,56
92,Torrey Craig\craigto01,SF,28,DEN,7,6,141,13,31,.419,3,17,.176,10,14,.714,.468,3,4,.750,12,13,25,5,4,3,6,18,32
93,Jamal Crawford\crawfja01,SG,38,PHO,7,0,70,7,20,.350,4,12,.333,3,8,.375,.450,8,8,1.000,0,4,4,9,2,0,4,5,26
94,Jae Crowder\crowdja01,SF,28,UTA,8,1,247,34,76,.447,18,47,.383,16,29,.552,.566,23,31,.742,9,38,47,14,5,1,1,23,109
95,Dante Cunningham\cunnida01,PF,31,SAS,7,4,142,7,22,.318,2,8,.250,5,14,.357,.364,4,4,1.000,6,22,28,7,4,1,2,11,20
96,Seth Curry\curryse01,SG,28,POR,8,0,149,18,41,.439,11,20,.550,7,21,.333,.573,1,1,1.000,2,10,12,9,0,1,6,14,48
97,Stephen Curry\curryst01,PG,30,GSW,10,10,341,111,206,.539,59,116,.509,52,90,.578,.682,44,48,.917,4,50,54,60,11,3,29,23,325
98,Troy Daniels\danietr01,SG,27,PHO,4,0,37,5,15,.333,3,11,.273,2,4,.500,.433,1,1,1.000,1,3,4,4,4,0,3,6,14
99,Anthony Davis\davisan02,C,25,NOP,5,5,185,44,89,.494,5,11,.455,39,78,.500,.522,33,46,.717,18,47,65,26,10,16,8,16,126
100,Ed Davis\davised01,C,29,BRK,9,0,153,24,38,.632,0,0,,24,38,.632,.632,10,16,.625,29,45,74,9,3,4,9,24,58
101,Dewayne Dedmon\dedmode01,C,29,ATL,5,0,92,14,29,.483,3,8,.375,11,21,.524,.534,6,6,1.000,6,25,31,3,2,9,1,14,37
102,Sam Dekker\dekkesa01,PF,24,CLE,7,3,131,17,35,.486,4,9,.444,13,26,.500,.543,6,8,.750,9,22,31,8,11,0,5,11,44
103,Matthew Dellavedova\dellama01,PG,28,MIL,4,0,25,3,9,.333,3,6,.500,0,3,.000,.500,0,0,,0,2,2,4,0,0,3,2,9
104,Luol Deng\denglu01,SF,33,MIN,1,0,12,2,7,.286,0,3,.000,2,4,.500,.286,0,0,,3,2,5,0,0,1,0,0,4
105,DeMar DeRozan\derozde01,SG,29,SAS,7,7,261,76,146,.521,3,11,.273,73,135,.541,.531,40,46,.870,4,36,40,51,9,2,15,21,195
106,Cheick Diallo\diallch01,PF,22,NOP,5,0,50,10,19,.526,0,0,,10,19,.526,.526,7,10,.700,6,15,21,4,1,2,4,5,27
107,Hamidou Diallo\diallha01,SG,20,OKC,7,0,98,16,33,.485,1,5,.200,15,28,.536,.500,8,11,.727,9,10,19,3,6,3,3,13,41
108,Gorgui Dieng\dienggo01,C,29,MIN,9,0,131,23,46,.500,2,9,.222,21,37,.568,.522,17,20,.850,11,36,47,8,5,4,9,20,65
109,Spencer Dinwiddie\dinwisp01,PG,25,BRK,9,0,247,48,101,.475,21,52,.404,27,49,.551,.579,14,18,.778,4,16,20,32,3,4,21,26,131
110,Donte DiVincenzo\divindo01,SG,22,MIL,8,0,165,24,51,.471,9,31,.290,15,20,.750,.559,9,11,.818,4,29,33,13,2,2,9,12,66
111,Luka Doncic\doncilu01,PF,19,DAL,9,9,313,63,135,.467,24,61,.393,39,74,.527,.556,25,36,.694,10,49,59,41,8,3,36,18,175
112,Tyler Dorsey\dorsety01,SG,22,ATL,5,0,52,10,23,.435,2,7,.286,8,16,.500,.478,2,4,.500,0,5,5,3,1,0,0,4,24
113,Damyean Dotson\dotsoda01,SG,24,NYK,7,4,214,36,81,.444,15,40,.375,21,41,.512,.537,3,6,.500,7,36,43,6,8,1,5,11,90
114,Goran Dragic\dragigo01,PG,32,MIA,7,7,222,43,103,.417,17,45,.378,26,58,.448,.500,21,26,.808,5,19,24,35,3,2,16,18,124
115,Andre Drummond\drumman01,C,25,DET,7,7,226,56,114,.491,1,8,.125,55,106,.519,.496,20,32,.625,40,74,114,8,6,10,22,29,133
116,Jared Dudley\dudleja01,PF,33,BRK,9,9,233,17,45,.378,11,34,.324,6,11,.545,.500,7,8,.875,8,21,29,23,8,2,6,24,52
117,Kris Dunn\dunnkr01,PG,24,CHI,1,1,30,4,13,.308,1,4,.250,3,9,.333,.346,0,0,,0,4,4,7,0,0,4,6,9
118,Kevin Durant\duranke01,PF,30,GSW,10,10,354,106,189,.561,17,43,.395,89,146,.610,.606,54,59,.915,2,75,77,59,9,7,27,16,283
119,Henry Ellenson\ellenhe01,PF,22,DET,1,0,8,2,5,.400,1,2,.500,1,3,.333,.500,2,2,1.000,0,3,3,0,0,0,0,1,7
120,Joel Embiid\embiijo01,C,24,PHI,9,9,310,91,189,.481,13,42,.310,78,147,.531,.516,62,76,.816,24,83,107,34,2,21,21,31,257
121,James Ennis\ennisja01,SF,28,HOU,4,4,89,8,22,.364,6,15,.400,2,7,.286,.500,0,2,.000,6,4,10,3,3,1,2,15,22
122,Drew Eubanks\eubandr01,PF,21,SAS,2,0,6,1,2,.500,0,0,,1,2,.500,.500,2,2,1.000,0,0,0,0,0,0,0,0,4
123,Jacob Evans\evansja02,SG,21,GSW,6,0,38,2,7,.286,0,0,,2,7,.286,.286,0,0,,1,2,3,7,1,0,1,4,4
124,Tyreke Evans\evansty01,SG,29,IND,8,0,159,33,77,.429,10,23,.435,23,54,.426,.494,9,14,.643,3,19,22,23,9,5,12,16,85
125,Dante Exum\exumda01,PG,23,UTA,8,0,151,24,61,.393,5,18,.278,19,43,.442,.434,20,28,.714,4,13,17,18,2,2,8,14,73
126,Kenneth Faried\farieke01,PF,29,BRK,3,0,15,4,5,.800,0,0,,4,5,.800,.800,0,0,,1,3,4,0,1,0,2,0,8
127,Derrick Favors\favorde01,C,27,UTA,7,7,157,29,59,.492,2,11,.182,27,48,.563,.508,15,22,.682,23,28,51,3,3,9,11,23,75
128,Cristiano Felicio\feliccr01,C,26,CHI,6,0,130,14,25,.560,0,0,,14,25,.560,.560,9,12,.750,11,29,40,5,2,2,7,10,37
129,Raymond Felton\feltora01,PG,34,OKC,2,0,32,6,17,.353,0,6,.000,6,11,.545,.353,6,7,.857,1,6,7,4,0,1,3,2,18
130,Terrance Ferguson\fergute01,SG,20,OKC,8,8,165,10,29,.345,4,19,.211,6,10,.600,.414,1,2,.500,5,7,12,5,4,1,9,23,25
131,Yogi Ferrell\ferreyo01,SG,25,SAC,8,2,133,17,43,.395,5,18,.278,12,25,.480,.453,10,10,1.000,2,11,13,8,5,1,4,6,49
132,Dorian Finney-Smith\finnedo01,SF,25,DAL,9,4,229,31,59,.525,13,31,.419,18,28,.643,.636,6,8,.750,17,16,33,8,9,4,9,30,81
133,Bryn Forbes\forbebr01,PG,25,SAS,7,7,208,35,75,.467,15,36,.417,20,39,.513,.567,9,11,.818,2,10,12,19,7,0,9,19,94
134,Evan Fournier\fournev01,SG,26,ORL,8,8,229,47,119,.395,14,49,.286,33,70,.471,.454,17,22,.773,2,20,22,32,6,0,11,19,125
135,De'Aaron Fox\foxde01,PG,21,SAC,9,9,293,60,119,.504,7,23,.304,53,96,.552,.534,44,65,.677,8,33,41,70,13,4,30,26,171
136,Melvin Frazier\frazime01,G,22,ORL,1,0,6,0,0,,0,0,,0,0,,,0,0,,0,0,0,0,0,0,0,1,0
137,Tim Frazier\fraziti01,PG,28,NOP,5,2,88,9,18,.500,4,11,.364,5,7,.714,.611,1,3,.333,2,8,10,14,2,1,6,13,23
138,Channing Frye\fryech01,C,35,CLE,1,1,21,2,4,.500,1,2,.500,1,2,.500,.625,0,0,,0,4,4,1,0,0,0,4,5
139,Markelle Fultz\fultzma01,SG,20,PHI,9,9,218,38,93,.409,4,13,.308,34,80,.425,.430,9,15,.600,13,25,38,36,9,1,13,24,89
140,Danilo Gallinari\gallida01,SF,30,LAC,9,9,261,55,122,.451,20,42,.476,35,80,.438,.533,48,49,.980,11,42,53,14,6,4,9,18,178
141,Langston Galloway\gallola01,SG,27,DET,6,0,134,11,31,.355,3,21,.143,8,10,.800,.403,5,6,.833,1,11,12,4,2,1,1,9,30
142,Marc Gasol\gasolma01,C,34,MEM,7,7,227,37,84,.440,14,28,.500,23,56,.411,.524,21,30,.700,5,54,59,28,16,4,10,15,109
143,Pau Gasol\gasolpa01,C,38,SAS,7,0,121,17,33,.515,3,5,.600,14,28,.500,.561,10,12,.833,10,33,43,22,1,6,6,10,47
144,Rudy Gay\gayru01,SF,32,SAS,7,6,205,42,80,.525,9,14,.643,33,66,.500,.581,7,11,.636,10,49,59,14,9,4,17,18,100
145,Paul George\georgpa01,SF,28,OKC,8,8,277,61,155,.394,23,71,.324,38,84,.452,.468,36,46,.783,5,49,54,31,19,7,26,26,181
146,Taj Gibson\gibsota01,PF,33,MIN,9,9,235,41,70,.586,4,10,.400,37,60,.617,.614,9,14,.643,24,32,56,11,8,9,10,24,95
147,Harry Giles\gilesha01,PF,20,SAC,7,0,75,12,34,.353,0,1,.000,12,33,.364,.353,2,7,.286,5,15,20,5,3,2,10,20,26
148,Shai Gilgeous-Alexander\gilgesh01,PG,20,LAC,9,0,223,26,57,.456,3,8,.375,23,49,.469,.482,19,21,.905,5,21,26,28,8,4,17,17,74
149,Rudy Gobert\goberru01,C,26,UTA,8,8,274,51,69,.739,0,0,,51,69,.739,.739,35,53,.660,30,80,110,9,10,20,17,24,137
150,Aaron Gordon\gordoaa01,PF,23,ORL,8,8,251,41,96,.427,10,33,.303,31,63,.492,.479,20,32,.625,16,47,63,17,7,8,19,23,112
151,Eric Gordon\gordoer01,SG,30,HOU,7,5,233,36,112,.321,13,55,.236,23,57,.404,.379,20,22,.909,5,19,24,12,2,5,9,13,105
152,Marcin Gortat\gortama01,C,34,LAC,8,8,133,10,25,.400,0,0,,10,25,.400,.400,9,11,.818,13,31,44,12,0,6,9,19,29
153,Devonte' Graham\grahade01,PG,23,CHO,2,0,19,3,6,.500,1,3,.333,2,3,.667,.583,0,0,,0,2,2,3,0,0,1,2,7
154,Treveon Graham\grahatr01,SG,25,BRK,2,0,27,0,3,.000,0,2,.000,0,1,.000,.000,0,0,,1,3,4,1,1,0,2,5,0
155,Jerami Grant\grantje01,PF,24,OKC,8,5,237,31,67,.463,7,25,.280,24,42,.571,.515,17,29,.586,9,29,38,13,8,10,9,22,86
156,Jerian Grant\grantje02,PG,26,ORL,8,0,166,15,44,.341,3,16,.188,12,28,.429,.375,4,8,.500,5,14,19,22,10,1,13,16,37
157,Danny Green\greenda02,SG,31,TOR,9,9,275,32,73,.438,24,52,.462,8,21,.381,.603,5,5,1.000,6,34,40,13,10,9,8,19,93
158,Draymond Green\greendr01,PF,28,GSW,10,10,316,33,68,.485,6,23,.261,27,45,.600,.529,12,18,.667,10,65,75,85,20,9,32,33,84
159,Gerald Green\greenge01,SG,33,HOU,7,0,143,21,55,.382,12,42,.286,9,13,.692,.491,5,5,1.000,7,14,21,4,3,1,4,11,59
160,JaMychal Green\greenja01,PF,28,MEM,2,2,39,6,15,.400,1,2,.500,5,13,.385,.433,2,2,1.000,4,8,12,4,4,0,4,4,15
161,Jeff Green\greenje02,PF,32,WAS,8,1,198,25,59,.424,3,21,.143,22,38,.579,.449,19,19,1.000,8,29,37,10,4,5,12,19,72
162,Blake Griffin\griffbl01,PF,29,DET,7,7,255,67,136,.493,19,39,.487,48,97,.495,.563,38,52,.731,14,60,74,30,3,5,22,19,191
163,Tim Hardaway\hardati02,SG,26,NYK,9,9,301,76,177,.429,34,84,.405,42,93,.452,.525,40,44,.909,4,26,30,29,8,0,19,27,226
164,James Harden\hardeja01,SG,29,HOU,4,4,144,37,79,.468,15,34,.441,22,45,.489,.563,25,34,.735,4,21,25,36,8,2,20,9,114
165,Maurice Harkless\harklma01,SF,25,POR,5,0,88,7,18,.389,3,8,.375,4,10,.400,.472,2,2,1.000,3,21,24,5,2,6,2,10,19
166,Montrezl Harrell\harremo01,C,25,LAC,9,0,184,39,63,.619,0,0,,39,63,.619,.619,30,43,.698,7,46,53,11,7,17,12,29,108
167,Devin Harris\harride01,PG,35,DAL,1,0,6,0,2,.000,0,1,.000,0,1,.000,.000,0,0,,0,0,0,1,0,0,0,0,0
168,Gary Harris\harriga01,SG,24,DEN,8,8,266,57,122,.467,10,37,.270,47,85,.553,.508,26,32,.813,7,24,31,28,9,5,7,15,150
169,Joe Harris\harrijo01,SG,27,BRK,9,9,275,46,84,.548,27,46,.587,19,38,.500,.708,6,8,.750,7,28,35,23,4,1,16,27,125
170,Tobias Harris\harrito02,PF,26,LAC,9,9,298,72,135,.533,15,38,.395,57,97,.588,.589,32,39,.821,11,64,75,17,2,6,15,14,191
171,Andrew Harrison\harrian01,PG,24,MEM,1,0,5,1,2,.500,0,1,.000,1,1,1.000,.500,0,0,,0,0,0,0,0,0,0,1,2
172,Shaquille Harrison\harrish01,PG,25,CHI,3,0,36,8,16,.500,2,5,.400,6,11,.545,.563,5,10,.500,3,5,8,8,2,0,3,7,23
173,Josh Hart\hartjo01,SG,23,LAL,8,3,232,35,78,.449,17,42,.405,18,36,.500,.558,8,15,.533,3,31,34,11,14,3,11,24,95
174,Isaiah Hartenstein\harteis01,PF,20,HOU,6,0,41,4,10,.400,0,2,.000,4,8,.500,.400,4,4,1.000,2,2,4,4,1,4,3,11,12
175,Udonis Haslem\hasleud01,C,38,MIA,1,0,4,0,2,.000,0,2,.000,0,0,,.000,0,0,,0,1,1,0,0,0,2,1,0
176,Gordon Hayward\haywago01,SF,28,BOS,7,7,174,30,70,.429,11,27,.407,19,43,.442,.507,8,13,.615,7,29,36,15,7,1,10,11,79
177,John Henson\hensojo01,C,28,MIL,8,0,121,18,42,.429,6,15,.400,12,27,.444,.500,6,10,.600,13,42,55,6,6,9,8,10,48
178,Juan Hernangomez\hernaju01,PF,23,DEN,7,0,123,15,32,.469,9,20,.450,6,12,.500,.609,6,7,.857,8,19,27,3,4,4,4,9,45
179,Willy Hernangomez\hernawi01,C,24,CHO,8,0,109,17,34,.500,3,6,.500,14,28,.500,.544,15,19,.789,17,25,42,5,4,2,9,17,52
180,Mario Hezonja\hezonma01,SF,23,NYK,9,0,154,34,86,.395,9,34,.265,25,52,.481,.448,4,10,.400,1,25,26,9,5,0,11,14,81
181,Buddy Hield\hieldbu01,SG,25,SAC,9,9,290,69,130,.531,22,45,.489,47,85,.553,.615,18,22,.818,7,47,54,25,5,6,24,23,178
182,George Hill\hillge01,PG,32,CLE,8,8,204,39,72,.542,10,19,.526,29,53,.547,.611,13,15,.867,8,6,14,20,6,1,11,22,101
183,Solomon Hill\hillso01,SF,27,NOP,8,1,142,8,29,.276,3,14,.214,5,15,.333,.328,3,4,.750,2,15,17,14,6,3,5,11,22
184,Aaron Holiday\holidaa01,PG,22,IND,5,0,16,2,6,.333,1,4,.250,1,2,.500,.417,0,0,,0,1,1,2,0,0,3,2,5
185,Jrue Holiday\holidjr01,SG,28,NOP,8,8,282,49,116,.422,8,37,.216,41,79,.519,.457,32,40,.800,6,26,32,66,15,4,25,18,138
186,Justin Holiday\holidju01,SG,29,CHI,9,9,309,39,90,.433,27,66,.409,12,24,.500,.583,7,8,.875,3,29,32,23,11,4,5,19,112
187,John Holland\hollajo02,SF,30,CLE,1,0,1,0,0,,0,0,,0,0,,,0,0,,0,0,0,0,0,0,0,0,0
188,Rondae Hollis-Jefferson\holliro01,SF,24,BRK,6,0,126,22,55,.400,0,5,.000,22,50,.440,.400,4,9,.444,5,30,35,8,4,4,4,10,48
189,Richaun Holmes\holmeri01,C,25,PHO,7,0,38,2,6,.333,0,0,,2,6,.333,.333,2,4,.500,5,9,14,2,1,2,2,6,6
190,Rodney Hood\hoodro01,SG,26,CLE,8,8,222,40,94,.426,6,22,.273,34,72,.472,.457,20,22,.909,4,18,22,17,10,1,4,20,106
191,Al Horford\horfoal01,C,32,BOS,8,8,236,37,87,.425,13,42,.310,24,45,.533,.500,11,14,.786,15,38,53,33,5,11,16,19,98
192,Dwight Howard\howardw01,C,33,WAS,1,1,23,7,8,.875,0,0,,7,8,.875,.875,6,8,.750,2,1,3,1,2,0,1,4,20
193,Kevin Huerter\huertke01,SG,20,ATL,8,0,112,13,30,.433,9,19,.474,4,11,.364,.583,4,5,.800,6,23,29,10,3,2,5,5,39
194,Chandler Hutchison\hutchch01,SF,22,CHI,8,3,149,13,29,.448,2,10,.200,11,19,.579,.483,5,10,.500,5,23,28,4,3,3,5,13,33
195,Serge Ibaka\ibakase01,C,29,TOR,9,5,248,60,115,.522,4,23,.174,56,92,.609,.539,23,32,.719,22,44,66,9,7,14,19,26,147
196,Andre Iguodala\iguodan01,SF,35,GSW,9,0,171,10,28,.357,2,11,.182,8,17,.471,.393,3,6,.500,4,18,22,27,8,6,8,13,25
197,Ersan Ilyasova\ilyaser01,PF,31,MIL,8,1,187,28,54,.519,8,23,.348,20,31,.645,.593,10,13,.769,13,40,53,11,6,3,6,24,74
198,Joe Ingles\inglejo01,SF,31,UTA,8,8,271,44,94,.468,22,55,.400,22,39,.564,.585,10,14,.714,2,37,39,32,13,2,25,20,120
199,Brandon Ingram\ingrabr01,SG,21,LAL,4,4,113,27,57,.474,4,11,.364,23,46,.500,.509,11,16,.688,6,10,16,4,4,5,11,14,69
200,Kyrie Irving\irvinky01,PG,26,BOS,8,8,255,54,123,.439,17,48,.354,37,75,.493,.508,18,23,.783,6,31,37,45,7,5,19,14,143
201,Jonathan Isaac\isaacjo01,SF,21,ORL,8,8,176,22,53,.415,5,19,.263,17,34,.500,.462,8,11,.727,11,32,43,4,6,8,6,17,57
202,Wesley Iwundu\iwundwe01,SF,24,ORL,4,0,76,8,25,.320,0,4,.000,8,21,.381,.320,8,12,.667,5,10,15,1,1,0,3,8,24
203,Frank Jackson\jacksfr01,PG,20,NOP,6,0,87,11,32,.344,5,14,.357,6,18,.333,.422,7,9,.778,0,4,4,5,2,0,1,9,34
204,Jaren Jackson\jacksja02,C,19,MEM,7,5,156,31,63,.492,3,15,.200,28,48,.583,.516,17,21,.810,9,23,32,9,8,7,10,31,82
205,Josh Jackson\jacksjo02,SG,21,PHO,8,3,173,27,68,.397,6,22,.273,21,46,.457,.441,4,11,.364,0,15,15,16,5,5,25,25,64
206,Justin Jackson\jacksju01,SF,23,SAC,9,2,238,24,64,.375,6,31,.194,18,33,.545,.422,8,11,.727,4,28,32,18,6,2,3,11,62
207,Reggie Jackson\jacksre01,PG,28,DET,7,7,213,35,98,.357,16,48,.333,19,50,.380,.439,27,32,.844,5,14,19,25,2,1,10,21,113
208,LeBron James\jamesle01,PF,34,LAL,8,8,291,81,159,.509,12,44,.273,69,115,.600,.547,48,61,.787,8,61,69,64,17,4,26,17,222
209,Jonas Jerebko\jerebjo01,PF,31,GSW,10,0,162,23,48,.479,11,25,.440,12,23,.522,.594,15,18,.833,9,34,43,15,6,1,7,25,72
210,Alize Johnson\johnsal02,PF,22,IND,3,0,9,1,2,.500,0,0,,1,2,.500,.500,0,2,.000,0,4,4,0,0,0,0,3,2
211,Amir Johnson\johnsam01,C,31,PHI,9,0,105,19,28,.679,0,2,.000,19,26,.731,.679,10,14,.714,8,27,35,12,2,3,11,17,48
212,Stanley Johnson\johnsst04,SF,22,DET,6,6,169,18,47,.383,8,28,.286,10,19,.526,.468,4,5,.800,6,24,30,11,4,1,13,15,48
213,Tyler Johnson\johnsty01,PG,26,MIA,7,0,168,22,54,.407,5,25,.200,17,29,.586,.454,9,14,.643,3,12,15,15,9,3,6,12,58
214,Wesley Johnson\johnswe01,SF,31,NOP,2,0,25,3,6,.500,2,4,.500,1,2,.500,.667,1,2,.500,0,2,2,0,2,1,2,5,9
215,Nikola Jokic\jokicni01,C,23,DEN,8,8,237,53,99,.535,11,26,.423,42,73,.575,.591,38,44,.864,17,63,80,53,10,10,21,26,155
216,Damian Jones\jonesda03,C,23,GSW,10,10,162,26,34,.765,0,0,,26,34,.765,.765,8,15,.533,13,13,26,11,6,11,5,27,60
217,Derrick Jones\jonesde02,SF,21,MIA,4,3,76,13,32,.406,3,9,.333,10,23,.435,.453,7,11,.636,6,5,11,4,2,2,4,13,36
218,Tyus Jones\jonesty01,PG,22,MIN,8,1,167,19,58,.328,10,26,.385,9,32,.281,.414,2,2,1.000,3,10,13,26,10,1,3,8,50
219,DeAndre Jordan\jordade01,C,30,DAL,9,9,304,43,66,.652,0,0,,43,66,.652,.652,28,34,.824,31,98,129,22,6,13,22,27,114
220,Cory Joseph\josepco01,PG,27,IND,9,0,219,27,51,.529,8,15,.533,19,36,.528,.608,2,5,.400,1,29,30,31,8,3,9,13,64
221,Frank Kaminsky\kaminfr01,PF,25,CHO,3,0,17,2,7,.286,0,3,.000,2,4,.500,.286,0,0,,0,3,3,2,0,0,2,1,4
222,Enes Kanter\kanteen01,C,26,NYK,9,5,232,54,101,.535,1,3,.333,53,98,.541,.540,18,21,.857,29,64,93,20,5,4,20,25,127
223,Luke Kennard\kennalu01,SG,22,DET,3,1,43,8,12,.667,1,2,.500,7,10,.700,.708,0,0,,0,5,5,3,1,1,1,2,17
224,Michael Kidd-Gilchrist\kiddgmi01,PF,25,CHO,9,0,198,33,66,.500,2,6,.333,31,60,.517,.515,17,24,.708,20,35,55,14,3,12,8,32,85
225,Maxi Kleber\klebima01,PF,27,DAL,9,0,169,25,49,.510,11,29,.379,14,20,.700,.622,7,11,.636,11,27,38,4,3,13,7,11,68
226,Kevin Knox\knoxke01,PF,19,NYK,3,0,56,11,31,.355,4,9,.444,7,22,.318,.419,2,5,.400,3,3,6,0,2,1,2,5,28
227,Furkan Korkmaz\korkmfu01,SG,21,PHI,5,0,26,2,5,.400,0,3,.000,2,2,1.000,.400,0,0,,0,5,5,0,1,0,0,3,4
228,Luke Kornet\kornelu01,PF,23,NYK,3,0,11,0,1,.000,0,1,.000,0,0,,.000,0,0,,0,0,0,2,0,0,1,0,0
229,Kyle Korver\korveky01,PF,37,CLE,7,0,109,12,25,.480,5,16,.313,7,9,.778,.580,4,5,.800,0,10,10,9,2,0,8,12,33
230,Kosta Koufos\koufoko01,C,29,SAC,3,0,36,9,14,.643,0,0,,9,14,.643,.643,0,0,,2,11,13,1,2,2,0,5,18
231,Rodions Kurucs\kurucro01,SF,20,BRK,3,0,43,9,19,.474,4,10,.400,5,9,.556,.579,4,4,1.000,4,8,12,1,0,0,5,3,26
232,Kyle Kuzma\kuzmaky01,SF,23,LAL,8,6,257,61,129,.473,14,47,.298,47,82,.573,.527,18,22,.818,6,34,40,14,2,6,7,21,154
233,Skal Labissiere\labissk01,PF,22,SAC,4,0,21,4,8,.500,1,4,.250,3,4,.750,.563,2,2,1.000,1,6,7,1,0,0,2,4,11
234,Jeremy Lamb\lambje01,SG,26,CHO,9,9,222,36,90,.400,12,35,.343,24,55,.436,.467,16,17,.941,6,32,38,14,10,5,3,20,100
235,Zach LaVine\lavinza01,SG,23,CHI,9,9,304,85,174,.489,21,57,.368,64,117,.547,.549,54,64,.844,3,44,47,34,7,6,36,29,245
236,Jake Layman\laymaja01,SF,24,POR,8,8,102,16,28,.571,7,14,.500,9,14,.643,.696,1,2,.500,3,10,13,3,2,3,4,7,40
237,T.J. Leaf\leaftj01,PF,21,IND,5,0,30,1,10,.100,0,3,.000,1,7,.143,.100,0,0,,2,3,5,2,0,1,2,1,2
238,Damion Lee\leeda03,SG,26,GSW,1,0,2,0,2,.000,0,1,.000,0,1,.000,.000,0,0,,0,0,0,0,0,0,0,1,0
239,Alex Len\lenal01,C,25,ATL,8,8,188,33,61,.541,4,13,.308,29,48,.604,.574,14,22,.636,14,33,47,13,3,10,13,22,84
240,Kawhi Leonard\leonaka01,SF,27,TOR,7,7,238,67,133,.504,13,29,.448,54,104,.519,.553,36,41,.878,8,45,53,24,14,4,11,12,183
241,Meyers Leonard\leoname01,C,26,POR,5,0,42,3,7,.429,1,4,.250,2,3,.667,.500,3,3,1.000,2,9,11,4,2,0,4,8,10
242,Jon Leuer\leuerjo01,PF,29,DET,1,0,6,1,2,.500,0,1,.000,1,1,1.000,.500,2,2,1.000,0,1,1,0,0,0,0,0,4
243,Caris LeVert\leverca01,SF,24,BRK,9,9,287,67,137,.489,14,42,.333,53,95,.558,.540,32,40,.800,7,34,41,40,11,3,22,26,180
244,Damian Lillard\lillada01,PG,28,POR,8,8,271,73,147,.497,24,60,.400,49,87,.563,.578,63,67,.940,7,34,41,48,5,2,20,13,233
245,Jeremy Lin\linje01,PG,30,ATL,8,0,126,21,51,.412,5,21,.238,16,30,.533,.461,17,21,.810,0,16,16,17,3,1,15,11,64
246,Shaun Livingston\livinsh01,PG,33,GSW,4,0,57,9,16,.563,0,0,,9,16,.563,.563,4,4,1.000,7,7,14,4,3,0,3,6,22
247,Zach Lofton\loftoza01,SG,26,DET,1,0,4,0,1,.000,0,1,.000,0,0,,.000,0,0,,0,0,0,0,1,0,1,0,0
248,Kevon Looney\looneke01,C,22,GSW,10,0,167,23,36,.639,0,0,,23,36,.639,.639,10,14,.714,22,25,47,14,3,7,7,18,56
249,Brook Lopez\lopezbr01,C,30,MIL,8,8,203,31,68,.456,17,47,.362,14,21,.667,.581,10,10,1.000,3,21,24,9,2,12,9,17,89
250,Robin Lopez\lopezro01,C,30,CHI,4,0,56,5,12,.417,0,0,,5,12,.417,.417,1,1,1.000,3,3,6,8,1,4,6,11,11
251,Kevin Love\loveke01,PF,30,CLE,4,4,136,21,65,.323,7,24,.292,14,41,.341,.377,27,33,.818,10,44,54,14,1,1,10,14,76
252,Kyle Lowry\lowryky01,PG,32,TOR,9,9,311,56,110,.509,23,57,.404,33,53,.623,.614,24,31,.774,5,32,37,101,13,5,26,22,159
253,Jordan Loyd\loydjo01,PG,25,TOR,1,0,2,0,0,,0,0,,0,0,,,0,0,,1,0,1,0,0,0,0,0,0
254,Timothe Luwawu-Cabarrot\luwawti01,SF,23,OKC,3,0,5,0,3,.000,0,2,.000,0,1,.000,.000,0,0,,0,1,1,0,0,0,0,1,0
255,Tyler Lydon\lydonty01,PF,22,DEN,3,0,8,1,1,1.000,0,0,,1,1,1.000,1.000,1,2,.500,1,0,1,0,0,0,0,1,3
256,Trey Lyles\lylestr01,PF,23,DEN,8,0,167,30,78,.385,3,24,.125,27,54,.500,.404,16,24,.667,8,34,42,15,8,3,18,15,79
257,Shelvin Mack\macksh01,PG,28,MEM,7,0,181,27,52,.519,8,15,.533,19,37,.514,.596,10,14,.714,1,17,18,27,5,0,9,12,72
258,Daryl Macon\maconda01,SG,23,DAL,1,0,1,0,0,,0,0,,0,0,,,0,0,,0,0,0,0,0,0,0,0,0
259,Ian Mahinmi\mahinia01,C,32,WAS,7,6,106,8,18,.444,0,2,.000,8,16,.500,.444,13,20,.650,10,17,27,3,4,3,5,23,29
260,Thon Maker\makerth01,C,21,MIL,3,0,41,7,12,.583,3,7,.429,4,5,.800,.708,2,4,.500,1,13,14,2,0,3,2,6,19
261,Boban Marjanovic\marjabo01,C,30,LAC,9,1,112,29,41,.707,0,1,.000,29,40,.725,.707,23,34,.676,12,38,50,5,3,8,12,19,81
262,Jarell Martin\martija01,PF,24,ORL,3,0,27,7,15,.467,0,4,.000,7,11,.636,.467,0,0,,0,5,5,2,0,0,0,2,14
263,Frank Mason\masonfr01,PG,24,SAC,8,0,126,21,53,.396,6,19,.316,15,34,.441,.453,12,17,.706,0,13,13,31,6,0,6,9,60
264,Wesley Matthews\matthwe02,SG,32,DAL,9,9,306,53,128,.414,25,72,.347,28,56,.500,.512,27,33,.818,6,18,24,23,7,0,13,25,158
265,Luc Mbah a Moute\mbahalu01,PF,32,LAC,4,0,61,8,18,.444,2,6,.333,6,12,.500,.500,2,5,.400,2,5,7,2,1,1,2,8,20
266,CJ McCollum\mccolcj01,SG,27,POR,8,8,254,50,125,.400,17,46,.370,33,79,.418,.468,26,32,.813,8,24,32,18,3,3,13,18,143
267,T.J. McConnell\mccontj01,PG,26,PHI,8,0,118,15,27,.556,0,2,.000,15,25,.600,.556,2,2,1.000,1,12,13,23,3,2,8,8,32
268,Doug McDermott\mcderdo01,SF,27,IND,9,0,155,22,41,.537,13,29,.448,9,12,.750,.695,6,7,.857,0,8,8,10,3,0,1,18,63
269,JaVale McGee\mcgeeja01,C,31,LAL,8,8,217,55,87,.632,1,2,.500,54,85,.635,.638,13,21,.619,24,36,60,10,8,26,14,29,124
270,Rodney McGruder\mcgruro01,SG,27,MIA,7,7,239,35,71,.493,17,34,.500,18,37,.486,.613,13,16,.813,7,35,42,26,6,3,10,23,100
271,Alfonzo McKinnie\mckinal01,SF,26,GSW,10,0,133,24,43,.558,10,17,.588,14,26,.538,.674,3,8,.375,15,28,43,2,2,2,4,21,61
272,Ben McLemore\mclembe01,SG,25,SAC,5,0,24,4,11,.364,4,9,.444,0,2,.000,.545,0,2,.000,0,0,0,1,0,0,1,3,12
273,Jordan McRae\mcraejo01,SG,27,WAS,3,0,21,1,7,.143,0,2,.000,1,5,.200,.143,0,0,,0,4,4,2,0,1,0,0,2
274,De'Anthony Melton\meltode01,PG,20,PHO,2,0,22,3,12,.250,1,6,.167,2,6,.333,.292,0,0,,0,2,2,1,3,1,2,5,7
275,Chimezie Metu\metuch01,PF,21,SAS,3,0,16,2,9,.222,0,1,.000,2,8,.250,.222,4,4,1.000,0,4,4,1,1,1,0,0,8
276,Khris Middleton\middlkh01,SF,27,MIL,8,8,249,51,109,.468,31,61,.508,20,48,.417,.610,28,32,.875,3,40,43,32,12,2,20,22,161
277,C.J. Miles\milescj01,SF,31,TOR,9,0,128,16,48,.333,9,31,.290,7,17,.412,.427,8,12,.667,2,12,14,7,2,5,5,15,49
278,Darius Miller\milleda01,SF,28,NOP,4,0,60,5,14,.357,4,11,.364,1,3,.333,.500,1,1,1.000,0,2,2,6,1,0,3,6,15
279,Patty Mills\millspa02,PG,30,SAS,7,0,187,19,46,.413,9,23,.391,10,23,.435,.511,9,11,.818,2,16,18,9,3,1,10,13,56
280,Paul Millsap\millspa01,PF,33,DEN,8,8,220,36,77,.468,5,15,.333,31,62,.500,.500,27,37,.730,19,43,62,10,8,11,13,19,104
281,Nikola Mirotic\mirotni01,PF,27,NOP,8,8,248,68,136,.500,21,57,.368,47,79,.595,.577,23,33,.697,24,58,82,12,7,5,9,19,180
282,Donovan Mitchell\mitchdo01,SG,22,UTA,7,7,246,62,139,.446,18,50,.360,44,89,.494,.511,21,27,.778,3,14,17,31,9,2,20,19,163
283,Malik Monk\monkma01,SG,20,CHO,9,0,214,41,102,.402,22,59,.373,19,43,.442,.510,14,14,1.000,2,14,16,18,5,4,11,20,118
284,Greg Monroe\monrogr01,C,28,TOR,3,0,10,1,5,.200,0,0,,1,5,.200,.200,0,0,,3,3,6,1,0,0,1,1,2
285,E'Twaun Moore\mooreet01,SF,29,NOP,8,8,255,48,90,.533,14,30,.467,34,60,.567,.611,13,16,.813,9,9,18,12,7,4,9,27,123
286,Marcus Morris\morrima03,PF,29,BOS,8,0,202,40,80,.500,20,39,.513,20,41,.488,.625,18,21,.857,6,51,57,8,4,2,14,27,118
287,Markieff Morris\morrima02,PF,29,WAS,7,7,183,29,59,.492,12,29,.414,17,30,.567,.593,10,13,.769,3,32,35,13,4,7,9,20,80
288,Monte Morris\morrimo01,PG,23,DEN,8,0,179,24,65,.369,7,16,.438,17,49,.347,.423,10,12,.833,5,14,19,29,10,0,5,11,65
289,Emmanuel Mudiay\mudiaem01,PG,22,NYK,2,0,18,3,5,.600,0,2,.000,3,3,1.000,.600,0,0,,1,1,2,4,3,0,1,1,6
290,Jamal Murray\murraja01,PG,21,DEN,8,8,253,45,106,.425,10,37,.270,35,69,.507,.472,22,25,.880,5,30,35,26,10,4,12,16,122
291,Dzanan Musa\musadz01,SG,19,BRK,3,0,15,3,6,.500,0,2,.000,3,4,.750,.500,0,2,.000,1,1,2,1,2,0,1,0,6
292,Mike Muscala\muscami01,PF,27,PHI,6,0,111,14,28,.500,8,20,.400,6,8,.750,.643,9,9,1.000,6,18,24,7,0,4,5,15,45
293,Svi Mykhailiuk\mykhasv01,SF,21,LAL,4,0,53,3,12,.250,1,5,.200,2,7,.286,.292,1,2,.500,2,2,4,6,2,0,3,3,8
294,Abdel Nader\naderab01,SF,25,OKC,3,0,6,0,1,.000,0,0,,0,1,.000,.000,0,0,,0,0,0,0,1,0,1,1,0
295,Larry Nance\nancela02,C,26,CLE,6,0,123,22,45,.489,0,1,.000,22,44,.500,.489,12,16,.750,12,20,32,21,9,1,3,19,56
296,Shabazz Napier\napiesh01,PG,27,BRK,6,0,85,15,40,.375,11,22,.500,4,18,.222,.513,12,15,.800,1,4,5,8,4,0,5,6,53
297,Georges Niang\niangge01,PF,25,UTA,8,0,67,13,23,.565,9,16,.563,4,7,.571,.761,5,5,1.000,2,13,15,3,3,1,3,7,40
298,Nerlens Noel\noelne01,C,24,OKC,8,1,116,25,35,.714,0,0,,25,35,.714,.714,10,15,.667,19,28,47,3,9,7,1,26,60
299,Frank Ntilikina\ntilila01,PG,20,NYK,9,9,272,28,76,.368,12,35,.343,16,41,.390,.447,9,10,.900,1,17,18,36,12,3,15,23,77
300,James Nunnally\nunnaja01,SF,28,MIN,3,0,29,3,8,.375,2,6,.333,1,2,.500,.500,3,3,1.000,0,3,3,3,0,0,0,2,11
301,Jusuf Nurkic\nurkiju01,C,24,POR,8,8,196,47,88,.534,2,10,.200,45,78,.577,.545,24,30,.800,27,49,76,11,7,6,18,22,120
302,David Nwaba\nwabada01,SG,26,CLE,5,0,38,4,9,.444,1,2,.500,3,7,.429,.500,4,4,1.000,0,6,6,2,0,2,1,2,13
303,Royce O'Neale\onealro01,SF,25,UTA,8,0,117,13,30,.433,4,8,.500,9,22,.409,.500,3,4,.750,2,18,20,5,3,0,8,13,33
304,Kyle O'Quinn\oquinky01,C,28,IND,6,0,43,11,20,.550,0,1,.000,11,19,.579,.550,6,6,1.000,6,11,17,7,1,4,4,9,28
305,Semi Ojeleye\ojelese01,PF,24,BOS,6,1,47,5,12,.417,2,7,.286,3,5,.600,.500,1,4,.250,2,6,8,0,2,0,0,7,13
306,Jahlil Okafor\okafoja01,C,23,NOP,5,2,55,12,26,.462,0,0,,12,26,.462,.462,6,6,1.000,10,7,17,1,0,0,6,10,30
307,Elie Okobo\okoboel01,PG,21,PHO,6,1,104,15,37,.405,5,17,.294,10,20,.500,.473,9,10,.900,2,8,10,17,1,0,9,17,44
308,Josh Okogie\okogijo01,SG,20,MIN,7,5,201,27,70,.386,6,26,.231,21,44,.477,.429,14,17,.824,10,27,37,9,11,4,11,15,74
309,Victor Oladipo\oladivi01,SG,26,IND,9,9,298,79,165,.479,20,52,.385,59,113,.522,.539,23,37,.622,6,55,61,40,14,4,19,19,201
310,Kelly Olynyk\olynyke01,PF,27,MIA,7,4,143,23,46,.500,8,27,.296,15,19,.789,.587,14,17,.824,7,14,21,17,5,3,7,15,68
311,Cedi Osman\osmande01,SF,23,CLE,8,8,257,38,99,.384,16,39,.410,22,60,.367,.465,13,18,.722,10,30,40,25,7,2,27,18,105
312,Kelly Oubre\oubreke01,SF,23,WAS,8,0,224,39,91,.429,14,42,.333,25,49,.510,.505,25,28,.893,8,33,41,4,4,6,14,19,117
313,Zaza Pachulia\pachuza01,C,34,DET,7,0,107,8,23,.348,0,0,,8,23,.348,.348,15,20,.750,14,18,32,14,6,3,4,20,31
314,Jabari Parker\parkeja01,PF,23,CHI,9,2,255,52,117,.444,10,31,.323,42,86,.488,.487,14,22,.636,12,46,58,18,6,4,18,14,128
315,Tony Parker\parketo01,PG,36,CHO,8,0,145,31,69,.449,3,7,.429,28,62,.452,.471,18,22,.818,1,10,11,41,1,0,10,10,83
316,Chandler Parsons\parsoch01,SF,30,MEM,3,3,46,7,17,.412,3,10,.300,4,7,.571,.500,0,0,,1,3,4,2,1,1,2,7,17
317,Patrick Patterson\pattepa01,PF,29,OKC,8,3,144,19,48,.396,10,29,.345,9,19,.474,.500,8,10,.800,10,20,30,1,3,4,3,10,56
318,Chris Paul\paulch01,PG,33,HOU,5,5,171,37,88,.420,13,35,.371,24,53,.453,.494,21,25,.840,7,23,30,44,9,2,13,16,108
319,Cameron Payne\payneca01,PG,24,CHI,9,8,209,30,70,.429,12,30,.400,18,40,.450,.514,12,12,1.000,6,13,19,34,5,2,14,20,84
320,Elfrid Payton\paytoel01,PG,24,NOP,5,5,144,24,48,.500,3,7,.429,21,41,.512,.531,7,11,.636,7,23,30,32,4,1,11,14,58
321,Theo Pinson\pinsoth01,SG,23,BRK,2,0,10,0,3,.000,0,2,.000,0,1,.000,.000,2,2,1.000,0,1,1,3,0,0,0,0,2
322,Mason Plumlee\plumlma01,C,28,DEN,8,0,139,29,43,.674,0,1,.000,29,42,.690,.674,6,17,.353,16,21,37,12,10,5,13,23,64
323,Miles Plumlee\plumlmi01,C,30,ATL,5,0,44,10,12,.833,0,0,,10,12,.833,.833,5,9,.556,6,7,13,6,2,0,4,4,25
324,Jakob Poeltl\poeltja01,C,23,SAS,4,3,42,4,7,.571,0,0,,4,7,.571,.571,0,0,,10,5,15,5,1,0,2,5,8
325,Quincy Pondexter\pondequ01,SF,30,SAS,4,0,33,4,8,.500,0,2,.000,4,6,.667,.500,2,2,1.000,3,6,9,1,5,0,1,4,10
326,Otto Porter\porteot01,SF,25,WAS,8,8,231,33,76,.434,9,32,.281,24,44,.545,.493,8,10,.800,6,34,40,10,11,5,6,14,83
327,Bobby Portis\portibo01,PF,23,CHI,4,4,113,17,41,.415,3,11,.273,14,30,.467,.451,5,9,.556,6,34,40,8,2,4,5,14,42
328,Dwight Powell\poweldw01,C,27,DAL,9,0,133,30,43,.698,3,10,.300,27,33,.818,.733,20,26,.769,11,23,34,9,8,4,9,26,83
329,Norman Powell\powelno01,SG,25,TOR,9,2,149,20,40,.500,9,20,.450,11,20,.550,.613,6,8,.750,1,18,19,9,4,1,6,13,55
330,Alex Poythress\poythal01,PF,25,ATL,5,0,89,11,21,.524,2,5,.400,9,16,.563,.571,6,13,.462,9,14,23,6,2,1,4,16,30
331,Zhou Qi\qizh01,PF,23,HOU,1,0,1,1,1,1.000,0,0,,1,1,1.000,1.000,0,0,,0,0,0,0,0,0,0,0,2
332,Ivan Rabb\rabbiv01,PF,21,MEM,3,0,26,3,5,.600,0,1,.000,3,4,.750,.600,3,5,.600,2,8,10,3,1,1,4,4,9
333,Julius Randle\randlju01,C,24,NOP,8,1,187,52,96,.542,4,14,.286,48,82,.585,.563,38,49,.776,13,48,61,17,6,4,20,31,146
334,J.J. Redick\redicjj01,SG,34,PHI,9,0,278,53,136,.390,33,83,.398,20,53,.377,.511,27,29,.931,4,26,30,30,4,1,12,13,166
335,Josh Richardson\richajo01,SG,25,MIA,7,7,239,47,116,.405,19,53,.358,28,63,.444,.487,21,24,.875,7,24,31,19,7,7,15,22,134
336,Malachi Richardson\richama01,SG,23,TOR,5,0,29,2,9,.222,2,9,.222,0,0,,.333,1,2,.500,1,3,4,0,0,0,1,4,7
337,Austin Rivers\riverau01,SG,26,WAS,8,0,186,19,51,.373,9,29,.310,10,22,.455,.461,5,7,.714,2,15,17,14,3,5,11,19,52
338,Duncan Robinson\robindu01,PF,24,MIA,1,0,10,1,3,.333,1,3,.333,0,0,,.500,0,0,,0,4,4,0,1,0,0,0,3
339,Glenn Robinson\robingl02,SF,25,DET,6,0,77,9,19,.474,1,5,.200,8,14,.571,.500,4,5,.800,2,7,9,0,2,1,2,3,23
340,Jerome Robinson\robinje01,SG,21,LAC,5,0,21,5,12,.417,2,5,.400,3,7,.429,.500,0,0,,0,2,2,0,0,0,1,3,12
341,Mitchell Robinson\robinmi01,C,20,NYK,7,4,119,16,24,.667,0,0,,16,24,.667,.667,6,10,.600,16,12,28,4,6,5,2,13,38
342,Rajon Rondo\rondora01,PG,32,LAL,5,2,139,24,45,.533,6,13,.462,18,32,.563,.600,2,2,1.000,4,17,21,37,5,0,13,16,56
343,Derrick Rose\rosede01,PG,30,MIN,9,1,244,57,128,.445,10,27,.370,47,101,.465,.484,29,38,.763,11,21,32,42,6,2,15,13,153
344,Terrence Ross\rosste01,SG,27,ORL,8,0,187,35,94,.372,14,46,.304,21,48,.438,.447,7,8,.875,3,16,19,16,10,5,8,21,91
345,Terry Rozier\roziete01,PG,24,BOS,8,0,186,23,62,.371,9,24,.375,14,38,.368,.444,7,8,.875,2,33,35,18,7,4,4,14,62
346,Ricky Rubio\rubiori01,PG,28,UTA,8,8,237,28,78,.359,11,32,.344,17,46,.370,.429,18,21,.857,2,19,21,61,9,2,26,23,85
347,D'Angelo Russell\russeda01,PG,22,BRK,9,9,249,48,120,.400,22,55,.400,26,65,.400,.492,15,19,.789,5,28,33,47,6,4,25,14,133
348,Domantas Sabonis\sabondo01,C,22,IND,8,0,177,42,62,.677,1,1,1.000,41,61,.672,.685,25,31,.806,24,46,70,16,6,6,18,23,110
349,Dario Saric\saricda01,PF,24,PHI,9,9,273,31,94,.330,12,50,.240,19,44,.432,.394,15,18,.833,17,46,63,20,4,2,16,29,89
350,Tomas Satoransky\satorto01,SG,27,WAS,8,0,105,9,26,.346,3,6,.500,6,20,.300,.404,12,12,1.000,3,12,15,20,1,2,3,12,33
351,Dennis Schroder\schrode01,PG,25,OKC,8,2,229,41,109,.376,10,30,.333,31,79,.392,.422,25,32,.781,5,27,32,48,8,1,22,27,117
352,Mike Scott\scottmi01,PF,30,LAC,9,0,112,13,24,.542,7,14,.500,6,10,.600,.688,0,0,,2,19,21,11,4,0,3,16,33
353,Wayne Selden\seldewa01,SG,24,MEM,7,0,109,19,36,.528,8,17,.471,11,19,.579,.639,5,7,.714,2,4,6,7,4,0,8,13,51
354,Collin Sexton\sextoco01,PG,20,CLE,8,0,194,32,75,.427,2,8,.250,30,67,.448,.440,30,33,.909,7,14,21,18,4,1,18,18,96
355,Landry Shamet\shamela01,SG,21,PHI,9,1,169,20,51,.392,14,37,.378,6,14,.429,.529,5,7,.714,2,9,11,7,5,1,3,11,59
356,Iman Shumpert\shumpim01,SG,28,SAC,7,5,157,24,50,.480,14,32,.438,10,18,.556,.620,6,7,.857,1,20,21,11,6,4,5,16,68
357,Pascal Siakam\siakapa01,PF,24,TOR,9,8,234,42,69,.609,3,13,.231,39,56,.696,.630,10,17,.588,12,49,61,19,11,5,14,25,97
358,Ben Simmons\simmobe01,PG,22,PHI,8,8,250,43,91,.473,0,0,,43,91,.473,.473,24,38,.632,22,54,76,67,8,5,28,26,110
359,Jonathon Simmons\simmojo02,SG,29,ORL,6,0,144,17,59,.288,4,21,.190,13,38,.342,.322,13,16,.813,6,13,19,16,2,2,9,15,51
360,Anfernee Simons\simonan01,SG,19,POR,2,0,3,1,2,.500,0,1,.000,1,1,1.000,.500,0,0,,0,0,0,0,0,0,0,1,2
361,Marcus Smart\smartma01,SG,24,BOS,8,0,186,12,36,.333,3,20,.150,9,16,.563,.375,11,15,.733,5,18,23,28,8,3,11,22,38
362,Dennis Smith\smithde03,PG,21,DAL,8,8,241,52,116,.448,11,33,.333,41,83,.494,.496,17,26,.654,5,13,18,30,8,3,27,23,132
363,Ish Smith\smithis01,PG,30,DET,7,0,201,33,66,.500,12,26,.462,21,40,.525,.591,4,5,.800,1,16,17,23,2,2,9,20,82
364,J.R. Smith\smithjr01,SG,33,CLE,4,0,48,3,13,.231,0,6,.000,3,7,.429,.231,4,4,1.000,0,4,4,1,3,0,3,3,10
365,Jason Smith\smithja02,C,32,WAS,6,1,89,10,24,.417,2,4,.500,8,20,.400,.458,7,8,.875,9,19,28,8,1,4,4,14,29
366,Tony Snell\snellto01,SG,27,MIL,8,0,131,21,38,.553,10,25,.400,11,13,.846,.684,3,5,.600,2,11,13,6,2,2,2,11,55
367,Ray Spalding\spaldra01,PF,21,DAL,1,0,1,0,0,,0,0,,0,0,,,0,0,,0,0,0,0,0,0,0,0,0
368,Omari Spellman\spellom01,PF,21,ATL,7,0,126,17,40,.425,7,18,.389,10,22,.455,.513,5,8,.625,13,16,29,8,3,2,6,13,46
369,Nik Stauskas\stausni01,SG,25,POR,8,0,177,27,58,.466,15,31,.484,12,27,.444,.595,12,12,1.000,4,17,21,17,3,1,7,9,81
370,Lance Stephenson\stephla01,SG,28,LAL,8,0,153,36,68,.529,9,20,.450,27,48,.563,.596,5,7,.714,8,26,34,21,9,0,11,18,86
371,Edmond Sumner\sumneed01,PG,23,IND,5,0,20,1,4,.250,0,1,.000,1,3,.333,.250,0,2,.000,1,0,1,1,1,0,1,3,2
372,Caleb Swanigan\swanica01,PF,21,POR,4,0,57,7,18,.389,1,2,.500,6,16,.375,.417,4,5,.800,6,21,27,2,1,0,6,11,19
373,Jayson Tatum\tatumja01,SF,20,BOS,8,8,260,44,108,.407,10,31,.323,34,77,.442,.454,30,34,.882,8,55,63,20,5,2,15,23,128
374,Jeff Teague\teaguje01,PG,30,MIN,7,7,212,28,78,.359,7,22,.318,21,56,.375,.404,26,28,.929,1,16,17,48,6,1,13,18,89
375,Garrett Temple\templga01,SG,32,MEM,7,7,217,31,68,.456,17,35,.486,14,33,.424,.581,19,23,.826,5,21,26,8,7,3,8,16,98
376,Milos Teodosic\teodomi01,PG,31,LAC,5,0,57,7,11,.636,5,8,.625,2,3,.667,.864,1,2,.500,2,9,11,13,1,1,7,7,20
377,Daniel Theis\theisda01,C,26,BOS,5,0,61,13,23,.565,2,5,.400,11,18,.611,.609,2,3,.667,7,10,17,4,0,1,4,13,30
378,Lance Thomas\thomala01,PF,30,NYK,9,5,154,11,33,.333,4,14,.286,7,19,.368,.394,10,11,.909,4,16,20,6,7,2,6,21,36
379,Klay Thompson\thompkl01,SG,28,GSW,10,10,331,78,174,.448,24,73,.329,54,101,.535,.517,18,21,.857,5,36,41,14,7,5,18,23,198
380,Tristan Thompson\thomptr01,C,27,CLE,8,8,214,28,58,.483,0,0,,28,58,.483,.483,7,12,.583,34,38,72,16,5,3,10,18,63
381,Anthony Tolliver\tollian01,PF,33,MIN,9,0,189,19,41,.463,16,36,.444,3,5,.600,.659,6,10,.600,3,23,26,8,5,8,6,23,60
382,Karl-Anthony Towns\townska01,C,23,MIN,9,9,293,54,125,.432,20,46,.435,34,79,.430,.512,36,40,.900,24,72,96,20,8,19,25,31,164
383,Allonzo Trier\trieral01,SG,23,NYK,9,0,194,34,64,.531,6,14,.429,28,50,.560,.578,23,26,.885,6,18,24,11,2,3,15,8,97
384,P.J. Tucker\tuckepj01,PF,33,HOU,7,7,253,20,47,.426,14,33,.424,6,14,.429,.574,5,8,.625,13,29,42,11,14,6,5,20,59
385,Evan Turner\turneev01,PG,30,POR,8,0,198,34,67,.507,1,7,.143,33,60,.550,.515,10,13,.769,3,37,40,36,9,3,17,20,79
386,Myles Turner\turnemy01,C,22,IND,9,9,244,47,90,.522,2,13,.154,45,77,.584,.533,14,19,.737,15,31,46,15,3,23,13,26,110
387,Ekpe Udoh\udohek01,C,31,UTA,5,0,30,0,0,,0,0,,0,0,,,4,6,.667,1,5,6,3,0,2,2,5,4
388,Tyler Ulis\ulisty01,PG,23,CHI,1,0,1,0,0,,0,0,,0,0,,,0,0,,0,0,0,0,0,0,0,0,0
389,Jonas Valanciunas\valanjo01,C,26,TOR,9,4,170,48,88,.545,4,12,.333,44,76,.579,.568,25,29,.862,21,44,65,11,5,9,10,30,125
390,Fred VanVleet\vanvlfr01,PG,24,TOR,5,0,119,21,50,.420,6,20,.300,15,30,.500,.480,6,11,.545,2,13,15,27,3,1,7,11,54
391,Noah Vonleh\vonleno01,PF,23,NYK,9,4,180,24,43,.558,2,7,.286,22,36,.611,.581,21,29,.724,21,50,71,17,6,8,10,23,71
392,Nikola Vucevic\vucevni01,C,28,ORL,8,8,233,63,114,.553,8,14,.571,55,100,.550,.588,18,22,.818,25,62,87,33,10,10,18,17,152
393,Dwyane Wade\wadedw01,SG,37,MIA,7,0,176,34,81,.420,13,29,.448,21,52,.404,.500,11,15,.733,11,20,31,21,3,3,17,16,92
394,Kemba Walker\walkeke02,PG,28,CHO,9,9,302,88,191,.461,38,95,.400,50,96,.521,.560,48,56,.857,4,34,38,54,7,3,17,15,262
395,John Wall\walljo01,PG,28,WAS,8,8,271,60,131,.458,9,37,.243,51,94,.543,.492,36,51,.706,6,19,25,59,17,9,34,23,165
396,Tyrone Wallace\wallaty01,PG,24,LAC,6,0,20,4,8,.500,0,0,,4,8,.500,.500,2,3,.667,0,2,2,1,0,0,1,2,10
397,Taurean Waller-Prince\princta02,SF,24,ATL,8,8,230,42,110,.382,18,54,.333,24,56,.429,.464,22,23,.957,2,40,42,26,11,2,31,29,124
398,Brad Wanamaker\wanambr01,PG,29,BOS,2,0,6,2,4,.500,0,1,.000,2,3,.667,.500,2,2,1.000,0,1,1,0,0,0,1,0,6
399,T.J. Warren\warretj01,SF,25,PHO,8,2,197,47,95,.495,12,26,.462,35,69,.507,.558,16,19,.842,8,21,29,12,4,5,12,17,122
400,Yuta Watanabe\watanyu01,SG,24,MEM,1,0,5,0,0,,0,0,,0,0,,,2,2,1.000,0,2,2,0,0,0,1,0,2
401,Thomas Welsh\welshth01,C,22,DEN,3,0,7,0,1,.000,0,1,.000,0,0,,.000,0,0,,0,2,2,2,0,0,0,1,0
402,Russell Westbrook\westbru01,PG,30,OKC,6,6,195,61,121,.504,2,18,.111,59,103,.573,.512,28,44,.636,7,44,51,53,14,1,23,18,152
403,Hassan Whiteside\whiteha01,C,29,MIA,7,7,207,35,71,.493,0,3,.000,35,68,.515,.493,21,38,.553,26,83,109,0,3,21,15,21,91
404,Andrew Wiggins\wiggian01,SF,23,MIN,6,6,184,39,91,.429,12,30,.400,27,61,.443,.495,14,17,.824,3,19,22,9,9,2,9,16,104
405,C.J. Williams\willicj01,SG,28,MIN,3,0,19,1,3,.333,0,2,.000,1,1,1.000,.333,0,0,,0,0,0,0,0,0,2,4,2
406,Johnathan Williams\willijo04,C,23,LAL,6,0,85,11,19,.579,0,0,,11,19,.579,.579,1,5,.200,11,10,21,4,1,3,2,19,23
407,Kenrich Williams\willike04,SF,24,NOP,3,0,18,2,4,.500,1,2,.500,1,2,.500,.625,0,0,,0,3,3,0,0,0,0,3,5
408,Lou Williams\willilo02,SG,32,LAC,9,0,214,53,118,.449,17,39,.436,36,79,.456,.521,48,52,.923,3,17,20,26,6,1,24,9,171
409,Marvin Williams\willima02,PF,32,CHO,9,9,207,23,64,.359,7,35,.200,16,29,.552,.414,5,8,.625,8,34,42,9,4,13,5,14,58
410,Robert Williams\williro04,C,21,BOS,4,0,12,1,1,1.000,0,0,,1,1,1.000,1.000,0,0,,2,0,2,1,0,3,0,1,2
411,Troy Williams\willitr02,SF,24,SAC,2,0,46,6,10,.600,3,6,.500,3,4,.750,.750,0,0,,0,6,6,1,1,2,0,6,15
412,Justise Winslow\winslju01,PF,22,MIA,3,0,73,8,24,.333,1,5,.200,7,19,.368,.354,7,11,.636,4,9,13,8,5,2,3,7,24
413,Christian Wood\woodch01,PF,23,MIL,3,0,15,1,4,.250,1,2,.500,0,2,.000,.375,3,4,.750,0,3,3,0,0,0,1,2,6
414,Delon Wright\wrighde01,PG,26,TOR,4,0,39,4,14,.286,1,3,.333,3,11,.273,.321,4,4,1.000,1,7,8,2,1,1,0,6,13
415,Guerschon Yabusele\yabusgu01,PF,23,BOS,5,0,18,2,6,.333,0,3,.000,2,3,.667,.333,0,0,,2,3,5,0,0,1,0,1,4
416,Thaddeus Young\youngth01,PF,30,IND,9,9,275,43,82,.524,3,10,.300,40,72,.556,.543,8,15,.533,16,31,47,12,14,6,8,20,97
417,Trae Young\youngtr01,PG,20,ATL,8,8,248,51,118,.432,16,48,.333,35,70,.500,.500,30,40,.750,3,20,23,56,4,2,29,18,148
418,Cody Zeller\zelleco01,C,26,CHO,9,9,204,32,53,.604,1,3,.333,31,50,.620,.613,17,18,.944,19,35,54,16,5,5,11,25,82
419,Ante Zizic\zizican01,C,22,CLE,7,0,43,8,14,.571,0,0,,8,14,.571,.571,8,12,.667,6,7,13,4,1,0,3,6,24
420,Ivica Zubac\zubaciv01,C,21,LAL,2,0,7,0,2,.000,0,0,,0,2,.000,.000,0,0,,2,1,3,1,0,1,0,5,0
